county,residential_taxable_value,agricultural_taxable_value,industrial_taxable_value,commercial_taxable_value,mineral_taxable_value,total_taxable_value,year
adams,41764820,40465410,2019480,52895400,0,137145110,1985
allen,423860680,74674400,52987960,116925450,0,668448490,1985
ashland,170136310,74180710,16736640,34763790,396400,296213850,1985
ashtabula,350934390,108289500,39004430,94840920,4394290,597463530,1985
athens,138065630,40576550,7409290,44294570,1623320,231969360,1985
auglaize,165708960,70365600,19117470,34667710,0,289859740,1985
belmont,262648510,44974780,23374640,68574530,7925030,407497490,1985
brown,86961970,58640350,3913810,19286010,0,168802140,1985
butler,1342391440,69933350,148856260,304030510,0,1865211560,1985
carroll,84757670,66297740,6139110,12838600,3768760,173801880,1985
champaign,115479780,69622770,10654830,19457270,0,215214650,1985
clark,532378930,64454770,32458280,125960780,0,755252760,1985
clermont,615655220,58527000,40213620,153937500,0,868333340,1985
clinton,118772140,77950030,12519720,32579180,0,241821070,1985
columbiana,350142630,87094690,25216240,60487230,1597140,524537930,1985
coshocton,120003610,57419230,27321190,28441710,5805620,238991360,1985
crawford,169188990,71391370,23569900,39661530,0,303811790,1985
cuyahoga,7328554190,991830,928153100,2547761940,0,10805461060,1985
darke,186526610,125877670,12634120,32140340,0,357178740,1985
defiance,151735470,62075110,22434630,33403590,0,269648800,1985
delaware,340823470,85007260,25886850,51962490,0,503680070,1985
erie,364387390,56888400,60763250,94576710,13870,576629620,1985
fairfield,438701110,88786930,27293370,75525900,186200,630493510,1985
fayette,75796360,77163010,6780680,21151150,0,180891200,1985
franklin,4069991420,68025160,501859330,1975470660,0,6615346570,1985
fulton,134879070,88025430,25049250,28863790,70,276817610,1985
gallia,76265720,32267850,2862060,52525950,1034510,164956090,1985
geauga,509847330,103065740,22830890,56547610,2775560,695067130,1985
greene,679467300,71552740,25021780,100812080,0,876853900,1985
guernsey,119953220,38225960,12612630,38781470,6644080,216217360,1985
hamilton,4012127780,13411260,543364140,1422201870,0,5991105050,1985
hancock,279579430,117451450,39401390,90150420,5000,526587690,1985
hardin,91626430,83371560,8310970,19435770,0,202744730,1985
harrison,51955620,28453690,8198050,10247000,4414530,103268890,1985
henry,93079510,83502240,13951050,15144790,0,205677590,1985
highland,92988730,63598800,5091420,19870720,0,181549670,1985
hocking,89788410,15616970,6182580,11637530,2386290,125611780,1985
holmes,74839550,82292040,8736510,16320080,4885330,187073510,1985
huron,211224510,67080560,17489980,46439970,31260,342266280,1985
jackson,81712890,34140940,9241570,16833130,300740,142229270,1985
jefferson,259210340,27766640,64142980,56048590,1457030,408625580,1985
knox,198911370,87035460,12823640,38461250,1859840,339091560,1985
lake,1353984460,40599050,157035790,347479110,0,1899098410,1985
lawrence,177556680,32269580,9265230,27903220,897800,247892510,1985
licking,563877220,110068130,44412050,126475210,2192320,847024930,1985
logan,168147900,69218600,8904960,35986090,0,282257550,1985
lorain,1294968180,67708990,119037540,309811710,521180,1792047600,1985
lucas,2005040730,50341380,160861000,784119700,0,3000362810,1985
madison,122154630,81200370,7628740,24274750,0,235258490,1985
mahoning,1122986760,66328960,68459300,271326090,7043270,1536144380,1985
marion,263412890,74760630,29868070,65010810,20250,433072650,1985
medina,721696570,84905150,43028160,112070030,4685260,966385170,1985
meigs,45475410,28592480,20149220,8791830,4401790,107410730,1985
mercer,132644670,102277160,16498030,32137630,2100,283559590,1985
miami,425151960,74673640,38609820,69839870,0,608275290,1985
monroe,36928330,26756280,21179460,5842030,5098000,95804100,1985
montgomery,2671098920,71734250,271203730,892947080,0,3906983980,1985
morgan,28493330,36957070,4761020,5297540,4237590,79746550,1985
morrow,94422120,57842640,3806160,10427430,1513870,168012220,1985
muskingum,259439520,57281810,17662850,73002500,12119430,419506110,1985
noble,26866020,30311690,2534030,5528620,4635340,69875700,1985
ottawa,209680160,55181580,12770730,55732910,28140,333393520,1985
paulding,60259190,59937940,5874540,10194890,0,136266560,1985
perry,75560190,35504710,5418380,14146530,5974710,136604520,1985
pickaway,134816430,81261300,19323780,26668470,0,262069980,1985
pike,58477700,26846540,1854580,11015050,0,98193870,1985
portage,563289450,66311110,41150580,109780530,8821760,789353430,1985
preble,150360310,77454890,8453310,18649310,0,254917820,1985
putnam,105043020,93104990,6418520,17551180,0,222117710,1985
richland,522898930,64881060,70391200,155798250,0,813969440,1985
ross,223183360,75819680,34499650,54375650,0,387878340,1985
sandusky,244298230,85343450,26949180,49537130,45290,406173280,1985
scioto,208171670,37460160,19134510,52442560,0,317208900,1985
seneca,203224940,95599590,27658310,37599090,28550,364110480,1985
shelby,148985140,74238970,30797350,33789920,0,287811380,1985
stark,1734374750,132276150,153137320,448896250,22582160,2491266630,1985
summit,2582293020,53218380,201756980,789154560,7706150,3634129090,1985
trumbull,1005140180,100807500,131853940,239712730,6039440,1483553790,1985
tuscarawas,280207490,75068610,31707490,75111920,9862930,471958440,1985
union,113424770,83894800,27052260,27433790,0,251805620,1985
van wert,95548880,77058860,14148370,20206790,3040,206965940,1985
vinton,24484070,21980330,4938890,2847190,1994410,56244890,1985
warren,513978510,65794270,22104530,117774950,0,719652260,1985
washington,203295080,62876760,33762580,53421420,3287220,356643060,1985
wayne,473646100,132494270,48740420,89756370,5164410,749801570,1985
williams,122870590,63039390,20493790,24501690,0,230905460,1985
wood,428207880,116673210,61300640,129825860,9500,736017090,1985
wyandot,68792410,66797570,10364790,12133470,560,158088800,1985
adams,45333700,38850320,52649070,9581290,0,146414380,1986
allen,427494620,73973470,53129550,120500880,0,675098520,1986
ashland,172675000,74224800,16884040,34550740,459050,298793630,1986
ashtabula,352404080,107599170,37621250,94890260,4583710,597098470,1986
athens,139774040,40397380,7374140,43533820,1891310,232970690,1986
auglaize,168432160,70204480,19631750,35202120,0,293470510,1986
belmont,263733340,44884340,22937070,68781760,7785260,408121770,1986
brown,88101200,55694580,3757500,19466580,0,167019860,1986
butler,1374289260,69535540,151752020,322951890,0,1918528710,1986
carroll,84964020,64784660,6315040,13850980,3676480,173591180,1986
champaign,117752380,65835870,10727630,19840710,0,214156590,1986
clark,552506610,59537220,34234440,134513680,0,780791950,1986
clermont,629496430,57867690,43324940,163861540,0,894550600,1986
clinton,119551550,77032580,12984620,34177680,0,243746430,1986
columbiana,354152940,89855470,24333330,64266560,1799440,534407740,1986
coshocton,119355500,56075980,28216520,28803350,5851500,238302850,1986
crawford,169810340,71307120,22454210,39612620,0,303184290,1986
cuyahoga,7437060850,1123990,946780940,2628663470,0,11013629250,1986
darke,188471620,125397650,12864690,32593540,0,359327500,1986
defiance,153432090,61457480,22493670,33717470,0,271100710,1986
delaware,362111840,83471310,27270400,56520210,0,529373760,1986
erie,370415260,56123920,60726220,95728950,13790,583008140,1986
fairfield,446905750,83338370,25470650,76579420,308150,632602340,1986
fayette,76473290,77134900,7138940,21799870,0,182547000,1986
franklin,4195572060,55263250,523029800,2103615930,0,6877481040,1986
fulton,137274890,87269980,26290900,29957880,70,280793720,1986
gallia,79165210,32436210,2986910,52540170,969040,168097540,1986
geauga,524963970,102747730,23510430,57870720,4130490,713223340,1986
greene,689545010,69703850,23443750,105209710,0,887902320,1986
guernsey,121360320,41313620,11731980,39036920,3023410,216466250,1986
hamilton,4084197830,13197730,555839550,1443478620,0,6096713730,1986
hancock,286960610,113836460,42549050,97148370,5000,540499490,1986
hardin,92499260,83351940,8569140,19328620,500,203749460,1986
harrison,52566310,28114430,8818780,10479800,4171650,104150970,1986
henry,94795830,83574040,14149110,14936520,0,207455500,1986
highland,94679330,63408950,5104930,20147540,0,183340750,1986
hocking,99050910,18528050,6767710,12429520,1867350,138643540,1986
holmes,85495270,89505610,9797970,19613120,4649440,209061410,1986
huron,213489910,66220250,17388950,48455430,74440,345628980,1986
jackson,82895000,33865440,9268220,17078510,303990,143411160,1986
jefferson,260157720,27282790,64095350,56575360,1446050,409557270,1986
knox,194550760,86503780,12382870,35326710,1603500,330367620,1986
lake,1377187590,43197560,165442870,351570740,0,1937398760,1986
lawrence,177634880,31924600,9386450,27488950,940050,247374930,1986
licking,573961970,108973830,44910050,132930890,1820940,862597680,1986
logan,173415680,64562500,9881500,37697940,0,285557620,1986
lorain,1303490690,70582520,115885610,311222700,422290,1801603810,1986
lucas,2033129160,49849850,159709810,790823810,0,3033512630,1986
madison,124147260,80763160,7794090,24919630,0,237624140,1986
mahoning,1127929370,66337890,66002880,278050830,6974630,1545295600,1986
marion,249906780,66460410,29260510,64943200,20250,410591150,1986
medina,727731640,82076950,44086700,115063350,4569850,973528490,1986
meigs,54130370,34614470,21238080,11098710,5432020,126513650,1986
mercer,135166700,102391040,16466200,32919040,1900,286944880,1986
miami,431232040,71402850,43164830,72081510,0,617881230,1986
monroe,38679660,27160110,19753130,5946130,4711440,96250470,1986
montgomery,2702393250,70560000,263062800,910970480,0,3946986530,1986
morgan,28794700,37020280,4761020,6140740,3682930,80399670,1986
morrow,95812170,57553380,3833630,10665970,1792100,169657250,1986
muskingum,262861990,57171570,17669170,76707250,11469290,425879270,1986
noble,27525950,30329040,2534030,5567320,5334590,71290930,1986
ottawa,227094460,55389750,14298900,63655560,28140,360466810,1986
paulding,62464280,55319850,6189700,9283820,0,133257650,1986
perry,77108250,35459120,5359100,13759500,5701650,137387620,1986
pickaway,137055990,81163620,19341390,30546140,0,268107140,1986
pike,58867260,27463030,1859440,10625340,0,98815070,1986
portage,567920570,69137390,42248990,112691150,8773110,800771210,1986
preble,153494930,77391830,8907670,18821850,0,258616280,1986
putnam,107843370,94022500,6418520,18310920,0,226595310,1986
richland,526076560,64686180,69904040,156382160,0,817048940,1986
ross,226153640,71913710,36264220,54612660,0,388944230,1986
sandusky,245255890,83932090,30317310,50191660,45080,409742030,1986
scioto,233918290,40328300,17998180,56200780,0,348445550,1986
seneca,205276330,95557010,27500540,40497020,12860,368843760,1986
shelby,150817740,74249690,32433980,35415950,0,292917360,1986
stark,1746399940,137553720,147087920,464440630,12678250,2508160460,1986
summit,2620373520,53388340,202370880,802994210,7958390,3687085340,1986
trumbull,1014246170,105643770,128590600,243713730,6660190,1498854460,1986
tuscarawas,323163560,79052330,33474100,84094900,10173050,529957940,1986
union,115242720,78630890,40854050,28524720,0,263252380,1986
van wert,97538760,77428200,13888290,21480870,0,210336120,1986
vinton,24889250,21819180,5246850,2939930,1960940,56856150,1986
warren,531025890,65304960,24936560,122841840,0,744109250,1986
washington,226012840,66442500,35880370,66333990,3732450,398402150,1986
wayne,481158790,131479900,51216890,91867540,5414310,761137430,1986
williams,124154550,62666160,21695580,25065770,0,233582060,1986
wood,493483510,115145910,62742310,133559150,9200,804940080,1986
wyandot,69951560,61282530,10426260,12585830,560,154246740,1986
adams,46342220,38417650,52631230,9722020,0,147113120,1987
allen,433234400,73820770,53097900,123028510,0,683181580,1987
ashland,175573550,61311790,16969670,36135800,450220,290441030,1987
ashtabula,353773780,103366380,38063300,95801750,4681900,595687110,1987
athens,141717480,39200980,7463060,47217100,2103070,237701690,1987
auglaize,183185830,55029360,19980080,40463770,0,298659040,1987
belmont,266060190,45129610,22177030,72148040,7603590,413118460,1987
brown,90523040,55140260,3896600,20121280,0,169681180,1987
butler,1485916070,60998920,165917600,348457430,0,2061290020,1987
carroll,85536230,64684990,6317270,14209580,2883420,173631490,1987
champaign,119558680,65484990,10811110,19451060,0,215305840,1987
clark,558469770,59530890,36619680,139491390,0,794111730,1987
clermont,679912960,52775770,47461630,189347230,0,969497590,1987
clinton,122894550,61331020,15403950,36071260,0,235700780,1987
columbiana,350716640,88858470,24201990,66503740,2468840,532749680,1987
coshocton,121152510,55726720,28133630,29421500,5697060,240131420,1987
crawford,170382430,71148410,21439970,39619350,0,302590160,1987
cuyahoga,7553499610,1204690,956812030,2764873060,0,11276389390,1987
darke,189746030,101685650,14020370,35591710,0,341043760,1987
defiance,154075990,48659130,22007300,37886550,0,262628970,1987
delaware,443803890,78718860,31279410,73704750,0,627506910,1987
erie,385307300,56156880,56369790,98803040,13790,596650800,1987
fairfield,481731850,82583110,25974050,80633830,210860,671133700,1987
fayette,77272350,77063250,7148300,22806750,0,184290650,1987
franklin,5087736650,65850010,635188200,2826026600,0,8614801460,1987
fulton,139814190,69777510,26808750,30397040,70,266797560,1987
gallia,81532150,33324310,2873200,57164260,360700,175254620,1987
geauga,615682160,114034490,27277020,67898530,3776580,828668780,1987
greene,770374790,59712640,24612470,116816970,0,971516870,1987
guernsey,122465150,38461220,11470360,39291190,5617960,217305880,1987
hamilton,4672431660,14407030,567098000,1911717280,0,7165653970,1987
hancock,292772820,113787950,43361240,95622270,5000,545549280,1987
hardin,89215920,63815890,8580220,21006170,490,182618690,1987
harrison,54472190,27556420,8354070,11667050,3484220,105533950,1987
henry,104612180,68879850,15067580,16507120,0,205066730,1987
highland,96829560,62983360,5057160,20561710,0,185431790,1987
hocking,100366205,16709100,7262580,12047875,1567390,137953150,1987
holmes,87116380,87902610,10038520,20090080,4067740,209215330,1987
huron,216719950,65998380,17629600,49823490,57850,350229270,1987
jackson,89140550,29033360,12935230,21139610,316880,152565630,1987
jefferson,260899860,29925560,64090330,56665940,1420110,413001800,1987
knox,188489630,68072360,12386550,36626700,1243570,306818810,1987
lake,1409178340,43385350,165212630,1098080440,0,2715856760,1987
lawrence,198121730,42642620,8648150,37718820,670730,287802050,1987
licking,598985650,104983260,46144670,152711130,1564840,904389550,1987
logan,177061370,63923530,10973480,38902000,0,290860380,1987
lorain,1321387950,71117060,115630400,317648810,346730,1826130950,1987
lucas,2070401990,48874890,159914250,827101440,0,3106292570,1987
madison,128834750,65966850,7760030,25081080,0,227642710,1987
mahoning,1087320980,64201390,65798710,296056460,7021970,1520399510,1987
marion,250439490,66276180,27761920,65878530,20250,410376370,1987
medina,746584850,82438880,47264600,118645940,4242820,999177090,1987
meigs,54814930,34402780,22538090,10327060,5016200,127099060,1987
mercer,152905190,91451620,11355140,38040990,2000,293754940,1987
miami,439188220,69768510,48774370,76012530,0,633743630,1987
monroe,38968430,27008990,20072360,5944360,4925590,96919730,1987
montgomery,2816736180,65928450,274672880,973682460,0,4131019970,1987
morgan,29368560,36878280,4761020,6283340,3689330,80980530,1987
morrow,95812830,50970520,4110160,11742740,1614950,164251200,1987
muskingum,266052660,57277330,17605880,77278190,9936860,428150920,1987
noble,27831390,28993770,2540480,5723120,5012660,70101420,1987
ottawa,241218260,54521380,14340840,63684940,28140,373793560,1987
paulding,63489680,54670870,5908290,9400960,0,133469800,1987
perry,84943370,34508890,5861660,14865990,4675470,144855380,1987
pickaway,159599890,65425440,20816510,31891350,0,277733190,1987
pike,63840610,29165840,2070510,12158640,0,107235600,1987
portage,577490400,69672110,43152770,114999350,7930870,813245500,1987
preble,156625450,68128750,11505170,22645550,0,258904920,1987
putnam,114072410,79961690,5944180,20137450,0,220115730,1987
richland,531439570,53478950,71069960,172133140,0,828121620,1987
ross,228684790,71011470,35101070,57192420,0,391989750,1987
sandusky,249729670,83639610,29803200,50755160,45220,413972860,1987
scioto,235771210,39600410,13621320,56769820,0,345762760,1987
seneca,222372280,82785910,23618790,50184860,12730,378974570,1987
shelby,168879690,63935170,37247610,37740320,0,307802790,1987
stark,1764941740,137781140,148705190,484960610,9269370,2545658050,1987
summit,2786347010,55791290,199973230,865506270,6326750,3913944550,1987
trumbull,991872520,112952750,126997960,252400950,7029160,1491253340,1987
tuscarawas,326725580,79018510,33402470,86417250,9878250,535442060,1987
union,117880260,78181800,46724510,29337490,0,272124060,1987
van wert,106658870,63104340,15464050,23129540,0,208356800,1987
vinton,25231720,21798790,5159210,3163700,1865380,57218800,1987
warren,558652910,65848630,26594620,133827860,0,784924020,1987
washington,227837290,65874920,35372790,67985920,3735320,400806240,1987
wayne,489628330,118978320,51380720,94005820,5041450,759034640,1987
williams,125938310,62409100,21361810,25589890,0,235299110,1987
wood,537035900,92834960,64106290,147654200,9200,841640550,1987
wyandot,71297850,61002320,10445980,13067750,560,155814460,1987
adams,47261440,38210260,52967370,9976670,0,148415740,1988
allen,443598620,56416690,54409520,127699710,0,682124540,1988
ashland,179306810,61417350,17442220,36973030,444830,295584240,1988
ashtabula,355990200,103758890,37305050,97608570,4092570,598755280,1988
athens,143803650,39129860,7442670,49122830,1117150,240616160,1988
auglaize,187591320,54827010,20376490,41160940,0,303955760,1988
belmont,259360800,43370440,20863340,75049400,5122500,403766480,1988
brown,109109460,48686470,3936460,21952260,0,183684650,1988
butler,1564545785,62009040,172148460,369476090,0,2168179375,1988
carroll,86797610,64276570,6316950,14922660,2812600,175126390,1988
champaign,121586610,64877630,10845820,20421400,0,217731460,1988
clark,566674650,59217860,38800960,144170310,0,808863780,1988
clermont,706627790,52665800,48242370,198386540,0,1005922500,1988
clinton,125680880,61788820,15669460,36204480,0,239343640,1988
columbiana,352728300,89441520,24087020,68534170,2940800,537731810,1988
coshocton,123131990,50854520,28397840,29665110,5535360,237584820,1988
crawford,177722320,52599360,23169140,44118490,0,297609310,1988
cuyahoga,9115074960,914490,1005844890,3206467700,0,13328302040,1988
darke,194301600,102338340,14045080,37056720,0,347741740,1988
defiance,155803100,48497510,19571880,37633350,0,261505840,1988
delaware,500495230,77028630,33638930,77485680,0,688648470,1988
erie,429081643,51346170,54651520,109498790,29690,644607813,1988
fairfield,499257880,82505390,26278810,90628050,204400,698874530,1988
fayette,84799860,54818730,7584610,26116370,0,173319570,1988
franklin,5287424470,65138180,657240340,2998616010,0,9008419000,1988
fulton,142327680,69520880,27811680,31570320,70,271230630,1988
gallia,82146510,32905610,2856050,58153410,677140,176738720,1988
geauga,638602080,113583100,27400590,68120290,3957630,851663690,1988
greene,795051690,59383380,24579060,128278820,0,1007292950,1988
guernsey,123525020,38501670,12272400,38932500,5305730,218537320,1988
hamilton,4800219310,13292550,566769820,2010991690,0,7391273370,1988
hancock,299906690,114180720,47655790,103892390,5000,565640590,1988
hardin,90515790,63611250,8826940,21131500,490,184085970,1988
harrison,54913620,27433670,8221810,11513300,3610280,105692680,1988
henry,106204460,68504070,14673570,17222500,0,206604600,1988
highland,109805320,50176560,5736530,23855940,0,189574350,1988
hocking,102503305,16733120,7217590,12533555,2095500,141083070,1988
holmes,91228440,88842550,10459370,21689140,3659760,215879260,1988
huron,237898440,52804020,20883490,58331690,99770,370017410,1988
jackson,89266520,28279310,10895930,21263770,294840,150000370,1988
jefferson,277091520,32515260,64296200,63937470,1436090,439276540,1988
knox,191806930,67604950,12466590,36574690,1240040,309693200,1988
lake,1544435240,46724830,180615790,1153236000,0,2925011860,1988
lawrence,193454820,33423890,8228470,36678010,667290,272452480,1988
licking,614608390,100311320,47238390,158596980,1514400,922269480,1988
logan,181967200,63936940,11669130,40616510,0,298189780,1988
lorain,1369138010,61444690,112416040,327804790,293750,1871097280,1988
lucas,2421998210,44361350,204227530,948330640,0,3618917730,1988
madison,132821630,64994350,7893560,26660260,0,232369800,1988
mahoning,1101871530,63748580,64694360,306994130,6992010,1544300610,1988
marion,251742450,62709740,27775900,68602070,17740,410847900,1988
medina,774805750,83662280,47608260,121705620,3787720,1031569630,1988
meigs,55402030,33237510,22536350,10580360,5043040,126799290,1988
mercer,157088809,91584050,10941140,38263040,2000,297879039,1988
miami,451002630,69153470,51382550,79354480,0,650893130,1988
monroe,39437130,26871510,19736610,6249360,4705130,96999740,1988
montgomery,2878863880,64569390,263210000,1031846840,0,4238490110,1988
morgan,36825380,32866450,4983190,15990890,3230130,93896040,1988
morrow,97668350,50488820,4274050,12609800,1629100,166670120,1988
muskingum,313497540,66535380,17679550,91997090,9712760,499422320,1988
noble,28275560,29077380,2555950,5803960,4716040,70428890,1988
ottawa,304900750,48379440,36275730,66073810,29540,455659270,1988
paulding,64620850,55171920,6654430,10008940,0,136456140,1988
perry,85894810,33819370,5872380,15321030,4358550,145266140,1988
pickaway,164880840,65856920,21087090,33466400,0,285291250,1988
pike,65059000,29112250,2047840,12300710,0,108519800,1988
portage,659810370,73565210,46120390,126709100,7618220,913823290,1988
preble,159802910,67534810,12686000,23507710,0,263531430,1988
putnam,118068040,80110740,5830770,20946460,0,224956010,1988
richland,531559310,52556750,70919350,174373050,0,829408460,1988
ross,232963040,70769140,34978250,58878440,0,397588870,1988
sandusky,258851460,64940650,30146050,49244010,45220,403227390,1988
scioto,237504670,39429860,13615390,60020220,0,350570140,1988
seneca,223607460,82804370,22920440,49538730,11950,378882950,1988
shelby,171230170,64067010,35823380,39340830,90,310461480,1988
stark,1776451080,144292490,160303340,556453150,8672150,2646172210,1988
summit,2863451310,53980410,198413930,903012050,6996550,4025854250,1988
trumbull,1003519270,110984470,121564800,256124280,7109590,1499302410,1988
tuscarawas,331124470,79717080,33702160,88161640,9637800,542343150,1988
union,121156800,79184560,49002290,30230750,0,279574400,1988
van wert,108765900,63057000,15528770,24296700,1010,211649380,1988
vinton,25987930,21376370,5169460,3287000,1859580,57680340,1988
warren,669520290,60729940,31075420,171300120,0,932625770,1988
washington,231144130,66214810,35802620,60996620,3826280,397984460,1988
wayne,500314520,118541070,53963160,99649290,4780980,777249020,1988
williams,139265240,46846670,23889300,28490820,0,238492030,1988
wood,556585090,91376310,63334040,152070140,9150,863374730,1988
wyandot,72136980,60831790,10661240,13386570,1600,157018180,1988
adams,48274430,37904730,52990120,9982560,0,149151840,1989
allen,453859520,56292190,55336600,134939390,0,700427700,1989
ashland,182056260,61580080,17442790,37824790,374260,299278180,1989
ashtabula,358402820,104152340,37611160,97832300,3489100,601487720,1989
athens,147176840,38695300,5034130,53912220,1420540,246239030,1989
auglaize,193080700,54517450,21492710,42593660,0,311684520,1989
belmont,261018660,43231900,20997090,74379520,6264860,405892030,1989
brown,112063140,48891880,3693330,22228900,0,186877250,1989
butler,1643548565,65067100,187615200,387605090,0,2283835955,1989
carroll,88474090,58209690,6270580,17780580,2501400,173236340,1989
champaign,140134100,56902500,11747810,26951770,0,235736180,1989
clark,693699310,52803400,47400660,176803340,0,970706710,1989
clermont,742274720,51303280,49375250,232688120,0,1075641370,1989
clinton,126998770,62408870,16569980,38397980,0,244375600,1989
columbiana,356927360,86962800,24156050,68223730,2919780,539189720,1989
coshocton,124855450,50335860,27533740,29983940,5675580,238384570,1989
crawford,178695720,52488060,23287690,44217630,0,298689100,1989
cuyahoga,9256735860,1060110,977292310,3407448910,0,13642537190,1989
darke,198068110,102703050,14688310,38687780,0,354147250,1989
defiance,159607370,48264290,18688070,37641170,0,264200900,1989
delaware,559784290,76588430,34860880,83899870,0,755133470,1989
erie,442973820,50719320,53921530,115045260,24980,662684910,1989
fairfield,628530850,79259860,29980130,121378590,278360,859427790,1989
fayette,86804280,54649110,7830350,26577660,0,175861400,1989
franklin,5469741280,63602840,681757060,3141633910,0,9356735090,1989
fulton,146274760,69661700,26947420,32770880,70,275654830,1989
gallia,83138550,33205090,2713880,60151790,615620,179824930,1989
geauga,665394410,114218170,28547540,72580720,2802810,883543650,1989
greene,817616410,59951240,25402570,145467170,0,1048437390,1989
guernsey,125142340,38408530,10947060,39740980,5157140,219396050,1989
hamilton,4934401190,12793620,569903630,2100110070,0,7617208510,1989
hancock,328275140,91653470,51770570,117851100,0,589550280,1989
hardin,91510290,63158530,8784800,21476710,490,184930820,1989
harrison,55307140,27706410,8360920,11389490,3403220,106167180,1989
henry,108880010,68205000,14709880,16996650,0,208791540,1989
highland,112705570,50350310,5782480,24760830,0,193599190,1989
hocking,104845410,16057500,6728960,12697460,1551410,141880740,1989
holmes,94355570,80661420,11114720,22768700,3518020,212418430,1989
huron,243322520,52054350,21725210,58988410,40510,376131000,1989
jackson,90096100,27800730,10901960,22214590,306860,151320240,1989
jefferson,276706640,31358700,64181930,63753260,1433060,437433590,1989
knox,197846250,68439170,12532420,37066060,1595480,317479380,1989
lake,1571955860,46704320,184451180,1163940320,0,2967051680,1989
lawrence,193737740,32603890,8152880,36075430,956370,271526310,1989
licking,633158500,99613710,47507910,164783490,1353360,946416970,1989
logan,214868880,49808960,21787250,45778030,0,332243120,1989
lorain,1400851060,61084000,114092600,335257540,256700,1911541900,1989
lucas,2471525720,42746660,205584230,951344140,0,3671200750,1989
madison,138389430,64707860,9374500,26965520,0,239437310,1989
mahoning,1123969930,64096960,68221500,316893220,6578600,1579760210,1989
marion,251076800,48367010,30031920,69215140,18330,398709200,1989
medina,869146160,107831100,46932360,147157230,3312880,1174379730,1989
meigs,56219250,33297870,22528910,11451700,4705220,128202950,1989
mercer,160746780,92112050,14429780,38843350,2000,306133960,1989
miami,563778920,60694360,58610880,99289000,0,782373160,1989
monroe,39952420,26759750,19611500,6204120,4825250,97353040,1989
montgomery,2948196080,62547120,275818440,1084542840,0,4371104480,1989
morgan,36943730,33905590,5004170,16281060,3247540,95382090,1989
morrow,99647300,50000450,4292530,12962570,1843110,168745960,1989
muskingum,316971480,65534040,17743760,92566450,8501830,501317560,1989
noble,29119410,29384590,2579650,5602410,4522000,71208060,1989
ottawa,313843050,48401770,36744750,67381020,29060,466399650,1989
paulding,65931200,36948210,6398710,9742690,0,119020810,1989
perry,86941780,33319410,6130150,16120310,4014210,146525860,1989
pickaway,170783940,66276050,21394030,34369210,0,292823230,1989
pike,66655150,28754930,1752410,12536330,0,109698820,1989
portage,669006660,73924750,45864360,129300230,7424000,925520000,1989
preble,162798110,67041960,12847270,24252570,0,266939910,1989
putnam,122014000,80007470,5936950,21531390,0,229489810,1989
richland,537068020,52422740,70761810,175534280,0,835786850,1989
ross,250618350,56425520,36149210,60281000,0,403474080,1989
sandusky,265281380,63946930,29674580,50643160,29820,409575870,1989
scioto,239789900,37450430,13575620,62152410,0,352968360,1989
seneca,225961110,81829520,23565200,52035130,11900,383402860,1989
shelby,177606160,63763890,37017770,45173840,290,323561950,1989
stark,1809177810,143370360,155314330,567275830,8272370,2683410700,1989
summit,2956498190,50184120,200905150,961118020,6561900,4175267380,1989
trumbull,1021199560,110369550,121368400,258628760,7272620,1518838890,1989
tuscarawas,342063780,78281510,34511460,96231030,9169850,560257630,1989
union,130431880,65241270,53187750,33750550,0,282611450,1989
van wert,110700510,62739570,15405800,24724650,1010,213571540,1989
vinton,26248740,21396630,5164000,3437090,1874960,58121420,1989
warren,706720760,60568700,30542950,181526180,0,979358590,1989
washington,234351710,65341250,36494180,62649830,3481430,402318400,1989
wayne,512696420,119139660,57287850,102820080,4465930,796409940,1989
williams,142156280,46050380,23910160,28675620,0,240792440,1989
wood,570358570,92025020,66283470,159652450,9200,888328710,1989
wyandot,77504440,45749770,12488930,14526370,1000,150270510,1989
adams,49495500,33923510,52991870,10966210,0,147377090,1990
allen,463626140,56040790,56295820,137565150,0,713527900,1990
ashland,208631640,51953280,19042710,42130490,336850,322094970,1990
ashtabula,394717290,108118080,45865230,109179790,3526660,661407050,1990
athens,177883530,43011080,5707320,69704550,1442560,297749040,1990
auglaize,220667260,48076650,22754740,44684800,0,336183450,1990
belmont,261797770,43085140,20766640,75252730,6250130,407152410,1990
brown,115489320,48972470,4396400,22481980,0,191340170,1990
butler,1986709820,81509550,246010190,483995610,0,2798225170,1990
carroll,89471130,58083830,6622590,17968110,2335630,174481290,1990
champaign,144954130,54927710,11645100,27692050,0,239218990,1990
clark,704894760,53220650,50639460,182887630,0,991642500,1990
clermont,897531160,57371880,37589920,287454930,0,1279947890,1990
clinton,137589170,55755470,16513190,39589360,0,249447190,1990
columbiana,356828740,85610200,23864570,68077010,1867010,536247530,1990
coshocton,126603520,51891620,27575570,30407660,5894150,242372520,1990
crawford,179877580,52414840,23387840,44815010,0,300495270,1990
cuyahoga,9377569890,1095900,980805240,3608663700,0,13968134730,1990
darke,227817670,91279910,14935090,40704200,0,374736870,1990
defiance,175265480,45446530,18658390,38421210,0,277791610,1990
delaware,684645270,69837140,39429120,101412460,0,895323990,1990
erie,459651440,50573020,54947370,121140940,24980,686337750,1990
fairfield,647311930,80652510,30300080,133185410,205500,891655430,1990
fayette,88458000,54874490,8134020,27267060,0,178733570,1990
franklin,6426724180,69182050,774106940,3466428490,0,10736441660,1990
fulton,188209890,65620940,31212810,37879240,110,322922990,1990
gallia,84258520,32680810,2755220,61583800,609880,181888230,1990
geauga,797098670,128897870,32794320,86148220,2683170,1047622250,1990
greene,1053535120,64912250,33534390,201727450,0,1353709210,1990
guernsey,126983440,38531880,10615360,39563680,5043000,220737360,1990
hamilton,6186398080,17313860,639744700,2520363330,0,9363819970,1990
hancock,337342630,93242450,62721040,116158220,0,609464340,1990
hardin,92938980,54884410,9128940,22529770,490,179482590,1990
harrison,55865850,27553040,8493790,11177970,3370950,106461600,1990
henry,118972810,69902630,15530570,18967690,0,223373700,1990
highland,115153070,50237840,5898240,25725470,0,197014620,1990
hocking,107090660,16089660,6847690,13040500,1463630,144532140,1990
holmes,97754810,82810550,12695020,24033070,3095400,220388850,1990
huron,247561610,51586450,23501870,62149190,47690,384846810,1990
jackson,91363190,27772890,10875000,23837120,313770,154161970,1990
jefferson,277528840,30606530,63788060,64739400,1449180,438112010,1990
knox,221852470,70154260,13113990,40341790,1515900,346978410,1990
lake,1613484320,44815710,194815140,1187542310,0,3040657480,1990
lawrence,195308970,32531500,8178720,36601990,951910,273573090,1990
licking,742622970,99542160,48045630,171203960,1253340,1062668060,1990
logan,222043160,49987670,23419040,46926630,0,342376500,1990
lorain,1439356580,59142460,120826980,336769570,249600,1956345190,1990
lucas,2533745790,43109890,206874890,967954800,0,3751685370,1990
madison,149362200,54319020,10141250,30764460,0,244586930,1990
mahoning,1185600540,63360770,69431670,321993680,6737290,1647123950,1990
marion,252405340,47979840,29531890,69864760,83430,399865260,1990
medina,902263000,107884860,48314440,157722840,3031220,1219216360,1990
meigs,57101600,33215260,22504290,11052770,4604530,128478450,1990
mercer,189521390,85410480,14480580,41072470,2000,330486920,1990
miami,578278660,59109160,60605930,103074590,0,801068340,1990
monroe,40461750,25853220,19265010,6327140,5046570,96953690,1990
montgomery,3724104110,62415040,278394630,1329998070,0,5394911850,1990
morgan,37646030,35070670,5058840,16307900,3163450,97246890,1990
morrow,101734930,44110510,4246570,13101220,1856760,165049990,1990
muskingum,320873660,65305180,18059330,94247520,8157520,506643210,1990
noble,31536700,32841870,2562850,5840220,4485380,77267020,1990
ottawa,324817940,48421890,37795690,70548020,29010,481612550,1990
paulding,67617310,36638420,6647150,10127940,0,121030820,1990
perry,91480770,32498180,6212300,16203700,3771860,150166810,1990
pickaway,198335300,56789490,21267860,37124310,0,313516960,1990
pike,68248300,28715920,1475730,13760690,0,112200640,1990
portage,685088590,74995490,45656740,136141990,6909220,948792030,1990
preble,175220520,58897750,13585210,25604500,0,273307980,1990
putnam,139466380,70739270,6301640,22061330,0,238568620,1990
richland,577728530,47745260,72110870,179603230,0,877187890,1990
ross,254318510,56503950,36261670,61455460,0,408539590,1990
sandusky,267700540,62810680,32911650,54317860,31220,417771950,1990
scioto,241683680,37151870,11610330,62483580,0,352929460,1990
seneca,236137110,72145330,25206010,50482680,11240,383982370,1990
shelby,212303680,61011260,39480840,47621210,290,360417280,1990
stark,1858047230,148321610,150437000,593219190,8037420,2758062450,1990
summit,3543438100,59940440,242256970,1156131820,5990830,5007758160,1990
trumbull,1052866130,108850810,122470770,263834790,6898740,1554921240,1990
tuscarawas,347780490,79580380,35719870,98829110,8447970,570357820,1990
union,136712000,66112780,51903180,34079340,0,288807300,1990
van wert,127591130,54236780,15442190,26887760,970,224158830,1990
vinton,26914300,21399760,5196730,3420780,1848930,58780500,1990
warren,743899890,61983730,33040680,190480400,0,1029404700,1990
washington,238258600,66150890,37232230,62650650,3318040,407610410,1990
wayne,535383880,97691510,61109380,109748640,4166200,808099610,1990
williams,145521520,46247180,24105440,29231060,0,245105200,1990
wood,649856310,79217400,67562200,175963000,8850,972607760,1990
wyandot,79185420,45386290,12296600,14671430,950,151540690,1990
adams,51791930,34754320,52991870,11331740,0,150869860,1991
allen,564607850,58462800,62183270,150877110,0,836131030,1991
ashland,212877850,51900410,19794110,43644870,391120,328608360,1991
ashtabula,397559970,108308870,45022380,108730730,3656150,663278100,1991
athens,180690060,42682500,5453840,69682440,1369030,299877870,1991
auglaize,225809720,47990130,24087500,48220410,0,346107760,1991
belmont,266931880,43412690,20892560,76922980,6102160,414262270,1991
brown,135732270,47956010,4909560,23057340,0,211655180,1991
butler,2043865180,74700210,262267600,475737510,0,2856570500,1991
carroll,91124630,58156750,6714640,18081430,2570700,176648150,1991
champaign,148663210,55281150,11705490,28067320,0,243717170,1991
clark,718855830,53990320,51491860,185854790,0,1010192800,1991
clermont,933842670,56872260,40177250,337572080,0,1368464260,1991
clinton,141459090,55697670,16605800,40738630,0,254501190,1991
columbiana,360458180,86720230,24555610,71082410,2308260,545124690,1991
coshocton,143487130,48870210,34462560,34249320,5743400,266812620,1991
crawford,187619890,49103600,22828870,44827380,0,304379740,1991
cuyahoga,11231249810,1155050,1090495570,4289017870,0,16611918300,1991
darke,232483120,91189620,15162350,41093620,0,379928710,1991
defiance,178306550,45411590,18752220,38810730,0,281281090,1991
delaware,745025300,70598070,38012160,112829600,0,966465130,1991
erie,545005400,52392230,57173120,140448760,20490,795040000,1991
fairfield,671181770,80095560,29915160,141447830,297460,922937780,1991
fayette,101644090,52991530,8850580,27190670,0,190676870,1991
franklin,6611546430,73238140,804888010,3545465630,0,11035138210,1991
fulton,192602330,64743200,34621240,39204130,110,331171010,1991
gallia,85169010,32432020,2755220,62245260,572270,183173780,1991
geauga,825399150,131029100,32913350,89968910,3253270,1082563780,1991
greene,1082218900,65842920,33276800,204506890,0,1385845510,1991
guernsey,142904250,33069840,10139730,41025480,5364940,232504240,1991
hamilton,6329696960,17146130,638313790,2567049400,0,9552206280,1991
hancock,346159930,94390060,64775540,110927520,0,616253050,1991
hardin,94854160,54053840,10387010,22698880,490,181994380,1991
harrison,56354530,27571320,8551220,11199600,3838260,107514930,1991
henry,122101470,58387180,14736820,18326050,0,213551520,1991
highland,128775950,49770090,6087520,26185910,0,210819470,1991
hocking,109675280,16530970,7026660,13531960,1350680,148115550,1991
holmes,100576690,84177420,15166010,26084890,4250450,230255460,1991
huron,268216630,49522410,24265880,69640520,37310,411682750,1991
jackson,93237440,27612350,10376320,24117590,324910,155668610,1991
jefferson,278386880,30467790,63762810,66328470,1457560,440403510,1991
knox,225724640,69870220,15683240,40819940,1570090,353668130,1991
lake,1853851110,47543440,204379640,540637160,0,2646411350,1991
lawrence,197319070,32521390,8099700,37171440,1010030,276121630,1991
licking,766554130,98126350,49506300,182217470,1316160,1097720410,1991
logan,229978900,50206720,24637320,48844440,0,353667380,1991
lorain,1708852390,56391260,126582830,362701460,277830,2254805770,1991
lucas,2791476320,44128130,205846780,1040070810,0,4081522040,1991
madison,168095490,54395120,9901220,31242940,0,263634770,1991
mahoning,1214988140,63632380,70318780,328691790,9290570,1686921660,1991
marion,254677830,47701200,30282560,73643110,100890,406405590,1991
medina,941888290,108383030,48579850,164302190,3835610,1266988970,1991
meigs,57869830,33212560,23571080,11312270,4615200,130580940,1991
mercer,194437080,85526530,14527590,42019640,1900,336512740,1991
miami,592606880,59335670,59651040,108229010,0,819822600,1991
monroe,41499910,26217740,19282380,6416830,5076600,98493460,1991
montgomery,3767800650,64469190,277721670,1329075100,0,5439066610,1991
morgan,40027670,35124630,5080640,16489920,3272670,99995530,1991
morrow,103728670,44075260,4399870,13512110,2478140,168194050,1991
muskingum,325493870,57542850,18886150,98936670,8154420,509013960,1991
noble,31929620,32460890,2562850,5837990,4831450,77622800,1991
ottawa,383732050,47068130,37745920,79251050,28340,547825490,1991
paulding,68934890,36526550,6598660,10204210,0,122264310,1991
perry,93000490,32184350,6302290,16284690,3750480,151522300,1991
pickaway,204105150,57123640,21224340,38217620,0,320670750,1991
pike,69409730,28585470,1475650,13895570,0,113366420,1991
portage,797990020,76883160,46483650,158283220,8524810,1088164860,1991
preble,178642670,58927980,13731730,25932570,0,277234950,1991
putnam,144283190,70351460,6899050,22502630,0,244036330,1991
richland,587263270,48144410,71935780,183394210,0,890737670,1991
ross,259406500,56958320,37305580,61942470,0,415612870,1991
sandusky,308653540,63098130,36304770,65949030,28490,474033960,1991
scioto,246203410,37963440,10836060,65918490,0,360921400,1991
seneca,238342910,72459840,27684780,53078370,11640,391577540,1991
shelby,222149840,61403800,40531990,48904210,2400,372992240,1991
stark,2139460170,161215880,148929240,610202250,8935630,3068743170,1991
summit,3621141760,58365030,223001140,1192649260,5949630,5101106820,1991
trumbull,1072484460,109166180,125175650,269286510,8703190,1584815990,1991
tuscarawas,357561950,81874710,36691100,102880410,9618810,588626980,1991
union,143135200,65770577,53607490,39137230,0,301650497,1991
van wert,129805400,54114130,15709460,27011450,23310,226663750,1991
vinton,28735710,22885460,4391260,3779970,1852920,61645320,1991
warren,867606150,63700680,42183880,221619620,0,1195110330,1991
washington,242106870,66877130,38338480,64066030,3404500,414793010,1991
wayne,548273640,97070310,62368700,113677010,4647820,826037480,1991
williams,163546330,42381920,24178670,30560550,0,260667470,1991
wood,666337710,79039690,68237120,184667660,8650,998290830,1991
wyandot,80574520,45132810,12321120,15730190,930,153759570,1991
adams,66303240,39035510,56549710,12482230,0,174370690,1992
allen,574448000,57762120,62568270,152458630,0,847237020,1992
ashland,217453190,52250490,19771420,44442990,362520,334280610,1992
ashtabula,402835100,108923080,45338870,111349200,3026710,671472960,1992
athens,184780830,42308900,5513020,70886470,1236410,304725630,1992
auglaize,231650740,47791360,24554740,50100760,0,354097600,1992
belmont,270224040,43768160,20730190,78581900,4938620,418242910,1992
brown,140626190,48429560,4848740,23348950,0,217253440,1992
butler,2115533010,74608220,267379670,470535120,0,2928056020,1992
carroll,100732090,59130550,6744210,18433670,2067230,187107750,1992
champaign,178960280,62088900,11760470,28364570,0,281174220,1992
clark,858056230,60499480,55844310,201558130,0,1175958150,1992
clermont,971807400,57426020,41349960,335056400,0,1405639780,1992
clinton,145535800,56335390,17091780,40962350,0,259925320,1992
columbiana,477132860,65839100,32983090,99746120,2765750,678466920,1992
coshocton,144203350,48274970,34503760,33766540,5457490,266206110,1992
crawford,188944560,48965270,22491260,44736830,0,305137920,1992
cuyahoga,11353944870,1249300,1093403150,4307334080,0,16755931400,1992
darke,238989980,91462920,15165200,42483170,0,388101270,1992
defiance,181765380,45858600,18741610,38879460,0,285245050,1992
delaware,791876470,70174560,38564360,116090380,0,1016705770,1992
erie,554895310,52696730,56207410,146869690,28900,810698040,1992
fairfield,725188510,80289250,30462560,144778190,174340,980892850,1992
fayette,104217680,52529670,9195230,27490310,2370,193435260,1992
franklin,6789002630,70334070,832718930,3578939440,0,11270995070,1992
fulton,198107480,64304130,31791180,40030160,110,334233060,1992
gallia,87353850,33056460,2644800,62552700,550240,186158050,1992
geauga,852236110,130985850,33802080,90230020,3086250,1110340310,1992
greene,1108749560,66457630,33832600,210530690,0,1419570480,1992
guernsey,144066440,32537990,10119370,41585630,4868850,233178280,1992
hamilton,6464911300,18205970,667985880,2543740690,0,9694843840,1992
hancock,434958620,92192620,64941540,119112470,0,711205250,1992
hardin,97686150,54466380,10817760,22747170,0,185717460,1992
harrison,56565200,27393480,8551220,11491480,3756620,107758000,1992
henry,126299760,58422690,15716100,18926850,0,219365400,1992
highland,131725920,50433400,5852140,26676520,0,214687980,1992
hocking,124324490,17089160,7593470,15429830,940380,165377330,1992
holmes,114987220,97246030,17014950,30051530,5342570,264642300,1992
huron,274203700,49010590,25002490,71176590,34820,419428190,1992
jackson,96032640,28062850,15850820,24183940,327240,164457490,1992
jefferson,280709780,30045160,63794150,68228520,1531890,444309500,1992
knox,230550470,70439720,16125680,41345630,1193360,359654860,1992
lake,1904062250,48020410,205548670,547722770,0,2705354100,1992
lawrence,226465600,34631480,9222010,51185220,762450,322266760,1992
licking,792187940,98373090,49025070,181999600,1403720,1122989420,1992
logan,262380160,52220740,24726370,50305750,0,389633020,1992
lorain,1751435260,55555390,129787030,369738530,269740,2306785950,1992
lucas,2819699970,43565250,203608770,1043604720,0,4110478710,1992
madison,174879840,54083610,9901880,32058760,0,270924090,1992
mahoning,1240069980,65056060,69545070,335322480,8753700,1718747290,1992
marion,269903120,50079730,29134630,78160570,10930,427288980,1992
medina,1078043020,115857090,49743870,178695100,3227330,1425566410,1992
meigs,62965760,34430510,23819170,12705280,4423500,138344220,1992
mercer,200283890,87370750,13940400,42253590,2000,343850630,1992
miami,674269170,64306400,61720930,118228860,0,918525360,1992
monroe,45195130,30548730,19234350,6951800,5165270,107095280,1992
montgomery,3812714700,68340750,283321840,1313811650,0,5478188940,1992
morgan,40729300,36424940,5080640,16211900,2835150,101281930,1992
morrow,107898600,44430480,4187490,13547300,1941270,172005140,1992
muskingum,329213640,57178690,19344530,100863260,7924440,514524560,1992
noble,32406170,32585300,2528570,5795420,5252200,78567660,1992
ottawa,389707590,47688970,58732190,81184040,28300,577341090,1992
paulding,78291160,39069010,6784210,10395700,0,134540080,1992
perry,98731970,33192410,6439090,17107950,3601780,159073200,1992
pickaway,209073500,57827460,21835250,41273580,0,330009790,1992
pike,70970650,28471170,1435530,14006000,0,114883350,1992
portage,826659060,77248450,48188680,160572120,8496670,1121164980,1992
preble,182798910,59099100,15231690,26592620,0,283722320,1992
putnam,148532800,70847200,7144440,22935370,0,249459810,1992
richland,595505940,48095780,63754510,183569680,0,890925910,1992
ross,265400250,58692640,36503550,63146200,0,423742640,1992
sandusky,313126100,62909870,36514950,65378470,27860,477957250,1992
scioto,274836900,41330370,11933350,78901130,0,407001750,1992
seneca,240901900,72245890,25387190,53958130,11710,392504820,1992
shelby,230255360,61877330,42438730,46902500,1880,381475800,1992
stark,2173498460,155830120,146624130,609871270,9421500,3095245480,1992
summit,3715187430,56971120,226588860,1173443230,6691580,5178882220,1992
trumbull,1088531740,108846260,123331020,272369570,8358240,1601436830,1992
tuscarawas,404836600,90977040,40540650,113164980,8756940,658276210,1992
union,175204950,76022520,56726050,40754220,0,348707740,1992
van wert,132962180,54043420,15571270,27455690,25600,230058160,1992
vinton,29307410,23193310,5004640,4270370,1812020,63587750,1992
warren,910582360,65601530,42630790,224625100,0,1243439780,1992
washington,257807470,73646320,41941950,74879760,3291600,451567100,1992
wayne,563095630,97427860,67133260,117887430,4465850,850010030,1992
williams,168060830,42417730,24518000,32815680,0,267812240,1992
wood,682171450,79172740,67214010,185482110,8650,1014048960,1992
wyandot,87525480,48229560,12461130,16273440,880,164490490,1992
adams,69199260,38386790,57116140,12916600,0,177618790,1993
allen,588057150,57609940,63802680,159488940,0,868958710,1993
ashland,244289160,59845660,19740590,44508290,452370,368836070,1993
ashtabula,443941740,114774150,43856100,115874970,2778830,721225790,1993
athens,205665660,44584580,5565280,77788270,1152540,334756330,1993
auglaize,263560100,63018870,26098450,56106020,0,408783440,1993
belmont,275415750,44761910,20643350,79009170,4966850,424797030,1993
brown,146582970,49876760,4863040,23222720,0,224545490,1993
butler,2381618990,93423300,287264450,512876910,0,3275183650,1993
carroll,102263740,59784530,6723780,18560090,2049070,189381210,1993
champaign,185031910,62819480,11929510,28924970,0,288705870,1993
clark,875356540,60788420,57092250,203971440,0,1197208650,1993
clermont,1117726060,65118210,48880350,362893990,0,1594618610,1993
clinton,181313040,71286620,22994280,54679470,0,330273410,1993
columbiana,475705380,60497670,32751030,100993500,2663760,672611340,1993
coshocton,146108630,47363590,33961590,36363620,5766770,269564200,1993
crawford,190379050,48875340,22578780,45221460,0,307054630,1993
cuyahoga,11486912510,1628050,1110623410,4318472510,0,16917636480,1993
darke,279927550,120285380,20122950,49712850,0,470048730,1993
defiance,205768100,64448640,17474880,43557930,0,331249550,1993
delaware,988230640,89317030,46333490,146240650,0,1270121810,1993
erie,570105500,52670560,56882140,150625880,28900,830312980,1993
fairfield,764067790,82139770,29940720,147486940,188900,1023824120,1993
fayette,107370270,52983200,9328010,29102620,2960,198787060,1993
franklin,7912604440,80379060,860870030,3692315350,0,12546168880,1993
fulton,219050940,75209670,32767540,40765220,110,367793480,1993
gallia,105969910,37948600,3054770,71381740,610540,218965560,1993
geauga,1023271840,165540010,40069090,101274280,2901580,1333056800,1993
greene,1214160640,81067900,35385170,233786640,0,1564400350,1993
guernsey,145379480,33135940,9822410,41539870,4635240,234512940,1993
hamilton,7332201630,24714640,702304390,2963431490,0,11022652150,1993
hancock,442515520,92277290,69780770,120330950,0,724904530,1993
hardin,118021360,72858360,12175720,25078290,0,228133730,1993
harrison,60171090,32533980,8449600,12704850,4442430,118301950,1993
henry,148193860,76946360,15446960,21276510,0,261863690,1993
highland,135483390,51102020,5808180,26884780,0,219278370,1993
hocking,128393930,17579820,8159770,15936930,918540,170988990,1993
holmes,119611320,96111410,19209540,32297340,6888660,274118270,1993
huron,280723880,49341860,26038640,72151840,31450,428287670,1993
jackson,109733570,32771470,16086710,28767330,341520,187700600,1993
jefferson,282886120,30184530,63579150,68858270,1536230,447044300,1993
knox,259914950,81250220,15845820,48455390,1576080,407042460,1993
lake,1960571870,47339910,207011500,558359980,0,2773283260,1993
lawrence,221017770,31739380,8734050,48573760,627810,310692770,1993
licking,928708590,114737950,52056980,207199590,1501530,1304204640,1993
logan,269929270,52876660,24790770,50409130,0,398005830,1993
lorain,1797142050,55765180,130999060,375430320,242670,2359579280,1993
lucas,2857619850,42971820,202566860,1067758250,0,4170916780,1993
madison,204179750,71164280,9735530,32596540,0,317676100,1993
mahoning,1501250920,81886420,77007580,418335140,8427710,2086907770,1993
marion,274108550,49807180,29826060,80036110,7110,433785010,1993
medina,1129245830,118464620,51337770,184201880,2906860,1486156960,1993
meigs,64211240,34297580,23967580,12895970,4461760,139834130,1993
mercer,226037880,106739070,16937680,47949820,2000,397666450,1993
miami,689601630,64347420,63715580,121147490,0,938812120,1993
monroe,45459540,30533900,19243830,6793840,5264470,107295580,1993
montgomery,4089243960,66136630,309507280,1313762210,0,5778650080,1993
morgan,42231150,35761410,5080640,16480050,2891150,102444400,1993
morrow,128615430,58056300,4442880,15297240,1886860,208298710,1993
muskingum,334758010,57883760,20923150,104362350,7818530,525745800,1993
noble,32724130,32469810,2480200,6030680,5006730,78711550,1993
ottawa,400520480,48078450,59162840,81569410,28300,589359480,1993
paulding,79991680,39236290,6821740,10103440,0,136153150,1993
perry,109562650,35819950,6786210,18231580,3415290,173815680,1993
pickaway,250442310,80225940,25570860,49575070,0,405814180,1993
pike,81630590,31067120,1646330,16227100,14900,130586040,1993
portage,853798670,77100310,52798530,162042340,8521500,1154261350,1993
preble,214604850,82164490,16585840,31012520,0,344367700,1993
putnam,169298230,90984480,9046200,22486830,0,291815740,1993
richland,699323300,65570180,76371390,214126010,0,1055390880,1993
ross,271525200,58611720,36652290,64202740,0,430991950,1993
sandusky,318448980,62845280,36597840,65838950,27580,483758630,1993
scioto,278096390,41269180,12011040,79092350,0,410468960,1993
seneca,261959050,93339510,27493160,55956320,13220,438761260,1993
shelby,277003700,82340610,49461200,51736650,1880,460544040,1993
stark,2238089340,157448370,147230140,617612790,9464000,3169844640,1993
summit,4262317910,63423680,235521130,1257333150,6320730,5824916600,1993
trumbull,1256885540,123333920,119785120,300005390,8016610,1808026580,1993
tuscarawas,412946950,90722530,42237020,114896270,8067070,668869840,1993
union,184002530,75684568,57181900,41211250,0,358080248,1993
van wert,141750620,71926370,14749450,28300040,580,256727060,1993
vinton,29962720,23135620,4163560,4215690,1883850,63361440,1993
warren,972059510,67805130,44714980,228900850,0,1313480470,1993
washington,260548270,73593470,41989680,73233030,4180220,453544670,1993
wayne,610801870,106018200,68228100,127931290,4404460,917383920,1993
williams,170390930,44176180,25406980,33156070,0,273130160,1993
wood,771652790,100457730,82263560,215255380,7950,1169637410,1993
wyandot,89182950,47756220,12494000,17114410,880,166548460,1993
adams,72210510,38436400,57116140,12906160,0,180669210,1994
allen,618837830,71232020,64308590,161621240,0,915999680,1994
ashland,252909240,60219880,19988520,44978470,410630,378506740,1994
ashtabula,452693300,115949550,44201320,116207540,2497820,731549530,1994
athens,210949960,44767460,5635780,80333350,1226890,342913440,1994
auglaize,271454370,62834380,25821580,55122290,0,415232620,1994
belmont,304918480,50154590,24625910,97893120,5093150,482685250,1994
brown,171530430,62217560,6219110,24674700,0,264641800,1994
butler,2484000640,92732720,289805910,505048070,0,3371587340,1994
carroll,105073770,61758680,8473620,19670730,1963750,196940550,1994
champaign,190264120,62802150,11168510,29004550,0,293239330,1994
clark,891113190,61590820,57581020,203884160,0,1214169190,1994
clermont,1180779030,65797400,67642530,386027070,0,1700246030,1994
clinton,188100940,71515460,22898400,56014000,0,338528800,1994
columbiana,484805150,59927040,31888240,102265090,2655860,681541380,1994
coshocton,163424900,50027770,33434810,37486830,5386440,289760750,1994
crawford,215029580,61375070,21708850,45624670,0,343738170,1994
cuyahoga,13167070410,2554630,1101054270,4493721140,0,18764400450,1994
darke,286898580,120004160,20288130,52021020,0,479211890,1994
defiance,207996450,63518060,17485060,45984350,0,334983920,1994
delaware,1084893850,88184060,47215520,156025670,590,1376319690,1994
erie,688495820,60672240,43700360,177350240,28900,970247560,1994
fairfield,794969880,83083430,29778730,147877930,57660,1055767630,1994
fayette,130633350,76286350,10569780,36981160,2960,254473600,1994
franklin,8107919960,80603470,849560750,3723444720,0,12761528900,1994
fulton,226807980,74605730,33112960,41755340,110,376282120,1994
gallia,107819690,37625000,3151490,72176640,554340,221327160,1994
geauga,1060866410,167495210,40441060,102376060,3114900,1374293640,1994
greene,1258954130,83030000,37010230,287405930,0,1666400290,1994
guernsey,154504040,33185130,9822850,41375860,4223460,243111340,1994
hamilton,7463607840,23741150,709563040,2963151580,0,11160063610,1994
hancock,456101780,92469150,69695850,124655120,0,742921900,1994
hardin,120103690,72942640,12034550,25542400,0,230623280,1994
harrison,60675170,32591780,7250100,12900530,3388540,116806120,1994
henry,150708530,77031420,14441460,22063320,0,264244730,1994
highland,155686370,66184700,6387900,30780800,0,259039770,1994
hocking,132959420,17762300,8101010,17034500,1249760,177106990,1994
holmes,125713570,99103900,21905460,34562010,8070190,289355130,1994
huron,311437530,78414420,28936930,70523070,29380,489341330,1994
jackson,111446740,32107320,18863860,29457250,342090,192217260,1994
jefferson,345455160,37447850,61041090,74149140,1465220,519558460,1994
knox,267018370,81610770,16113950,46345240,1489600,412577930,1994
lake,2241491490,54473340,215587390,608293610,0,3119845830,1994
lawrence,223932580,31432970,8680450,45937810,712560,310696370,1994
licking,968285280,115271050,52812870,217594640,1518600,1355482440,1994
logan,277316810,53005830,25054030,52061620,0,407438290,1994
lorain,2109717000,72793860,135021410,419434240,204970,2737171480,1994
lucas,3037243870,54850300,219541980,1129845450,0,4441481600,1994
madison,210513660,71997090,10472650,33443610,0,326427010,1994
mahoning,1536816760,81023850,77696070,416396800,8380440,2120313920,1994
marion,278598220,49404520,30038480,86292670,5730,444339620,1994
medina,1218079670,126032820,50459780,190696290,2316770,1587585330,1994
meigs,65482380,34245340,23966070,12871990,4386350,140952130,1994
mercer,232596930,107105277,17233800,48170950,1900,405108857,1994
miami,706834060,64023850,64941070,122031650,0,957830630,1994
monroe,46089750,30534460,19224600,6821620,5216970,107887400,1994
montgomery,4124510000,65547140,308536280,1299202870,0,5797796290,1994
morgan,49745440,41226580,5296540,17931630,3168140,117368330,1994
morrow,132338150,58270790,4429750,15491690,1612910,212143290,1994
muskingum,403072370,66891180,21991910,113954540,8894940,614804940,1994
noble,33169130,33109790,2589310,6076710,4996440,79941380,1994
ottawa,476872910,57806420,67160200,92080750,0,693920280,1994
paulding,82242830,39114490,6910170,10118260,0,138385750,1994
perry,113182020,35858730,6484590,18282370,3586310,177394020,1994
pickaway,260330440,80850190,28408510,47706170,74360,417369670,1994
pike,82823660,30975420,1646330,16257730,14900,131718040,1994
portage,1026067590,97375820,70591830,195109350,8665420,1397810010,1994
preble,219642980,82897910,16813560,32465870,0,351820320,1994
putnam,174004110,91204250,9565600,22451690,0,297225650,1994
richland,706285600,63754710,73997660,214258050,23240,1058319260,1994
ross,281734880,59805060,36783930,67248680,0,445572550,1994
sandusky,356621330,75820820,38134080,69083510,27090,539686830,1994
scioto,281184770,41435060,12018930,87696220,0,422334980,1994
seneca,265916680,93225480,27178090,59072170,10870,445403290,1994
shelby,285471260,82513950,48633740,53554160,430,470173540,1994
stark,2462805260,186047350,186703130,682706450,9296480,3527558670,1994
summit,4384227990,60937030,237558300,1288600790,5946830,5977270940,1994
trumbull,1277005890,122099540,115790800,307332980,8633380,1830862590,1994
tuscarawas,421340110,91113900,42809200,117980380,7841140,681084730,1994
union,197380170,75674448,59500980,42525330,0,375080928,1994
van wert,144202440,71463930,14545100,28205860,580,258417910,1994
vinton,32105630,25334710,4171840,4467660,1871000,67950840,1994
warren,1196408780,84222140,48533600,265812560,0,1594977080,1994
washington,265034410,75146710,41613470,77598600,3772360,463165550,1994
wayne,632171490,106948850,69591130,131471890,4943590,945126950,1994
williams,211869630,62789200,29113880,38075900,0,341848610,1994
wood,796095020,99577870,84567550,217425070,7950,1197673460,1994
wyandot,91006590,47771710,12806160,18323720,880,169909060,1994
adams,78420670,40866150,57177870,13724720,0,190189410,1995
allen,633964650,71002660,67488710,163878620,0,936334640,1995
ashland,262973530,60157830,20307420,45439990,317540,389196310,1995
ashtabula,461636840,118007950,43496170,117045860,1869690,742056510,1995
athens,219214880,44858000,5573780,79944640,1396570,350987870,1995
auglaize,278656150,62761670,27117790,57451790,0,425987400,1995
belmont,307729350,49964780,24916860,98041310,4723040,485375340,1995
brown,176248720,62685860,6302960,25322230,0,270559770,1995
butler,2592245440,84322330,304557010,562652250,0,3543777030,1995
carroll,134746510,78200270,10733390,23171810,1770390,248622370,1995
champaign,227005450,72684950,13836890,33605690,0,347132980,1995
clark,958739910,65538220,58369550,209768470,0,1292416150,1995
clermont,1254263280,66966030,62837300,389191700,0,1773258310,1995
clinton,195795300,72004440,23086380,59296940,0,350183060,1995
columbiana,592496180,66994560,33287410,116081440,2159570,811019160,1995
coshocton,166591640,51033090,33495160,37743270,4982740,293845900,1995
crawford,217363420,61851400,22022340,46158110,0,347395270,1995
cuyahoga,13292073030,2723240,1109705150,4572144980,0,18976646400,1995
darke,294358340,119793660,22453400,53595230,0,490200630,1995
defiance,211918410,64253550,17705700,44587090,0,338464750,1995
delaware,1200641380,91242740,47492840,159895660,100060,1499372680,1995
erie,691389460,61399070,43168590,180440000,29200,976426320,1995
fairfield,1081227010,107363800,31500270,183615750,198190,1403905020,1995
fayette,134351330,75991820,11016735,36451660,2960,257814505,1995
franklin,8398179780,83255430,856459370,3814969910,0,13152864490,1995
fulton,238289450,74731040,33646270,43350750,110,390017620,1995
gallia,110040700,37883360,3127430,74863860,432430,226347780,1995
geauga,1102302700,169131570,40913630,104874900,2316310,1419539110,1995
greene,1313072340,81780710,37256320,301399730,0,1733509100,1995
guernsey,158101000,33583730,9421890,40821090,3820700,245748410,1995
hamilton,7575593980,24087360,715692630,2984524080,0,11299898050,1995
hancock,529015180,99845850,70186220,127114690,0,826161940,1995
hardin,120472350,76256290,12464990,27693250,0,236886880,1995
harrison,61769330,32517530,7604390,12504440,3035820,117431510,1995
henry,155800190,76957740,13344940,21673920,0,267776790,1995
highland,160145810,66124130,6055440,33670940,0,265996320,1995
hocking,155899420,20309510,8882690,17503510,1078590,203673720,1995
holmes,149984730,114744100,24562070,36590300,7124590,333005790,1995
huron,316813080,80034300,31364990,72140620,32450,500385440,1995
jackson,113460700,32578540,17133670,30802570,344540,194320020,1995
jefferson,346731830,36713810,60444140,73954620,1436950,519281350,1995
knox,277966620,82520330,18284130,50173170,1209610,430153860,1995
lake,2296047770,53294790,214788460,613922590,0,3178053610,1995
lawrence,253911740,33122080,8336430,48861130,709730,344941110,1995
licking,1020548390,114421000,52903050,224860580,1130210,1413863230,1995
logan,330674110,66986030,26497050,59678640,0,483835830,1995
lorain,2174952330,72398370,134256870,425705150,129110,2807441830,1995
lucas,3086957070,50329880,218430580,1118084420,0,4473801950,1995
madison,219847580,72426400,10804140,35919730,0,338997850,1995
mahoning,1577795330,80904530,78426340,423633860,7094730,2167854790,1995
marion,340906680,63928370,34168170,94169400,5090,533177710,1995
medina,1573221150,179315760,68783830,250802050,1796740,2073919530,1995
meigs,67198400,34347030,23963910,12563890,4350280,142423510,1995
mercer,239491670,108055950,16997170,48519650,1900,413066340,1995
miami,882843930,82871710,72912200,137725380,0,1176353220,1995
monroe,49284840,34880270,19224600,7165520,4882020,115437250,1995
montgomery,4199987090,67510590,308205020,1329710970,0,5905413670,1995
morgan,50725510,41261100,5296540,17853680,2604770,117741600,1995
morrow,138744690,58557220,4433530,15741210,1688220,219164870,1995
muskingum,411344720,67278460,23943000,117281170,9932340,629779690,1995
noble,33825940,33310100,2589310,6537360,4230580,80493290,1995
ottawa,482514960,57024890,67153550,91385720,0,698079120,1995
paulding,88739770,43383550,7095430,10806790,0,150025540,1995
perry,116897660,36006470,6681040,18484010,3566390,181635570,1995
pickaway,269423420,81189960,28300150,49190520,392140,428496190,1995
pike,84507700,31236580,1493610,16554720,14900,133807510,1995
portage,1067860800,98644880,72496690,201888660,7819740,1448710770,1995
preble,226540780,83966770,17262340,32431110,0,360201000,1995
putnam,179980160,92143520,10393950,22900170,0,305417800,1995
richland,720298050,63833130,75767420,219043960,69260,1079011820,1995
ross,342327040,68376060,41249260,75895310,47490,527895160,1995
sandusky,363458430,81385400,38299810,70442160,27090,553612890,1995
scioto,298581800,43751230,12004210,86938780,0,441276020,1995
seneca,270752780,93397820,28728970,58128210,10360,451018140,1995
shelby,295343880,82764630,50461470,58720720,430,487291130,1995
stark,2515599410,185292410,170220790,654470850,7803350,3533386810,1995
summit,4522937360,59734900,242424210,1299932940,5151670,6130181080,1995
trumbull,1303937400,123570460,118968340,311861510,7222690,1865560400,1995
tuscarawas,503796720,104529230,42943910,130602460,7085170,788957490,1995
union,243548660,92259370,60146560,49046880,0,445001470,1995
van wert,147465840,71102570,14809940,28368960,580,261747890,1995
vinton,32591540,25309580,4262580,4450100,1837550,68451350,1995
warren,1282146870,87472170,49628450,279340720,0,1698588210,1995
washington,295004740,90919250,40138010,85607090,3350270,515019360,1995
wayne,654427380,108898240,70586910,145906090,4619880,984438500,1995
williams,216794890,63233060,30663320,40079460,0,350770730,1995
wood,828650400,99372130,88526800,219745080,7950,1236302360,1995
wyandot,110711530,57780170,14236190,18782940,17590,201528420,1995
adams,81366330,41035980,57216130,14503040,0,194121480,1996
allen,649014700,71150410,66304320,168245420,0,954714850,1996
ashland,330475090,61745530,21720750,55073670,393090,469408130,1996
ashtabula,584978540,144153390,48696280,136070120,1562390,915460720,1996
athens,264414190,52409260,5795570,92504710,1257300,416381030,1996
auglaize,331118810,58838860,29202700,60223220,0,479383590,1996
belmont,310834930,51150620,24884580,100853260,4524080,492247470,1996
brown,185705040,63614010,6575500,27544800,0,283439350,1996
butler,2909854470,89450920,332161570,606515690,0,3937982650,1996
carroll,154464790,61651580,9120020,23311440,1441760,249989590,1996
champaign,233016800,73106370,14058480,34419980,0,354601630,1996
clark,973153490,67195480,61507330,217689120,0,1319545420,1996
clermont,1487992870,75722660,75045550,461553660,0,2100314740,1996
clinton,228611760,68945620,24255520,63833900,0,385646800,1996
columbiana,602642680,68407370,34031620,118929060,1897920,825908650,1996
coshocton,170058440,51524150,33811710,38814230,4963610,299172140,1996
crawford,220282390,61772900,22348970,46873390,0,351277650,1996
cuyahoga,13429899640,3241410,1105990480,4745210690,0,19284342220,1996
darke,350631440,114355700,24371390,56039160,0,545397690,1996
defiance,239799300,59312710,17818590,47917640,0,364848240,1996
delaware,1476135220,95993130,51649920,212676090,20870,1836475230,1996
erie,722942040,48748460,43055910,194604920,22560,1009373890,1996
fairfield,1114094040,110121640,33454180,192971350,332720,1450973930,1996
fayette,138354230,76090220,11744880,39654160,2960,265846450,1996
franklin,9387619540,83018650,897865700,3932498020,0,14301001910,1996
fulton,299967590,74422790,36547540,52450950,110,463388980,1996
gallia,126732290,43125200,3127730,75505800,431100,248922120,1996
geauga,1226471400,181369980,42974870,109867210,2152290,1562835750,1996
greene,1562635010,90088160,39147540,349012110,0,2040882820,1996
guernsey,160995910,34182820,9276270,41233570,3525400,249213970,1996
hamilton,8279948810,25396830,726737560,2948164020,0,11980247220,1996
hancock,547718850,99842590,71207390,132524320,0,851293150,1996
hardin,130338470,69935080,12537190,27616870,0,240427610,1996
harrison,67245480,34213740,8289720,14762390,2905710,127417040,1996
henry,184774290,71102390,14355090,22199390,0,292431160,1996
highland,165552560,66590380,8131060,34447110,0,274721110,1996
hocking,162082830,20407610,8921690,19327590,890770,211630490,1996
holmes,157722570,118033640,25127580,38755330,6291500,345930620,1996
huron,326759250,79868610,30791280,74310190,27020,511756350,1996
jackson,128873350,35315020,17244800,32560210,349020,214342400,1996
jefferson,348814740,36509840,57653790,75761650,1445790,520185810,1996
knox,352342250,94298480,20020380,57640220,1129300,525430630,1996
lake,2346744790,53286430,223697470,630985090,253530,3254967310,1996
lawrence,259249100,32922190,8096830,51414040,683430,352365590,1996
licking,1244016710,128009380,54272050,232333010,1083970,1659715120,1996
logan,339494240,67963920,25941080,64305280,0,497704520,1996
lorain,2241702500,72816770,148260460,434497140,136150,2897413020,1996
lucas,3139339160,50182250,218891300,1134314950,0,4542727660,1996
madison,250354630,71019580,11757710,40985680,0,374117600,1996
mahoning,1760823900,87883190,81699030,432742450,6726960,2369875530,1996
marion,344300330,63419050,35378100,92283950,4390,535385820,1996
medina,1642403640,187331580,69985000,263995520,1582330,2165298070,1996
meigs,68850460,34321540,23942530,12904890,4336710,144356130,1996
mercer,276435720,104886150,17392540,49830900,1900,448547210,1996
miami,905771050,83486510,74174050,139681740,0,1203113350,1996
monroe,50131020,35234160,19933200,7584500,4740890,117623770,1996
montgomery,4800771150,79107880,307502080,1396591640,0,6583972750,1996
morgan,51808970,41291530,5298350,17801760,2251550,118452160,1996
morrow,165747450,53723540,4460250,17583080,1261570,242775890,1996
muskingum,419708840,67204730,25980400,122375670,9549150,644818790,1996
noble,45012100,38971710,2622040,8516360,3870980,98993190,1996
ottawa,496509470,56984180,67111600,94136380,0,714741630,1996
paulding,91210360,43369890,7545800,11059580,0,153185630,1996
perry,133435340,38691610,7037150,20199850,4144630,203508580,1996
pickaway,324449940,78802350,27220880,56467210,1084720,488025100,1996
pike,92530080,32459390,1598190,20288230,14900,146890790,1996
portage,1101293640,98790030,78719570,208052940,7152220,1494008400,1996
preble,269465240,83633020,19145640,33202020,0,405445920,1996
putnam,207614930,86216650,10100450,23267960,0,327199990,1996
richland,808721080,63810140,81244190,225883010,82890,1179741310,1996
ross,352286680,68820350,40037780,80379210,3000,541527020,1996
sandusky,370629530,81535830,41199210,75163980,27090,568555640,1996
scioto,300973030,44298560,11964470,83628890,950,440865900,1996
seneca,313069830,86822150,27987660,59452240,5590,487337470,1996
shelby,337606030,80587480,54522390,56423580,430,529139910,1996
stark,2592050530,179579830,171560120,687250640,7596920,3638038040,1996
summit,5655928230,72736340,255810760,1407857320,3492310,7395824960,1996
trumbull,1489045500,133265310,119778600,331310390,6642010,2080041810,1996
tuscarawas,515467870,105864880,43862430,135168720,6447360,806811260,1996
union,258022820,93646470,54784380,51767110,0,458220780,1996
van wert,177406920,64835080,15352050,29181590,580,286776220,1996
vinton,34032190,25710360,4271700,4568540,1805580,70388370,1996
warren,1369571070,91597760,56043100,300429190,0,1817641120,1996
washington,298624220,89347810,40031360,88412740,3092220,519508350,1996
wayne,815118390,118979640,78850970,162008880,4878650,1179836530,1996
williams,223353210,63577990,29826190,41772830,0,358530220,1996
wood,952519390,86652020,90254590,225886050,7950,1355320000,1996
wyandot,112757090,58146440,14975600,19151630,31010,205061770,1996
adams,84921450,42132200,57233910,14817330,0,199104890,1997
allen,733563270,73447460,66935050,195158810,0,1069104590,1997
ashland,342945590,61431180,23450410,56511190,355380,484693750,1997
ashtabula,597293320,144871230,47174860,142113650,1251860,932704920,1997
athens,270027420,52048530,5464000,93054520,1208450,421802920,1997
auglaize,339120980,58944700,29623540,62128150,0,489817370,1997
belmont,352304020,57363220,26695200,113408710,4594280,554365430,1997
brown,225069650,72308140,6585040,28349510,6210,332318550,1997
butler,3017127400,90817420,332529790,624431570,0,4064906180,1997
carroll,159208110,62300190,9523150,23570480,1412790,256014720,1997
champaign,241825290,73538810,15331410,34806100,0,365501610,1997
clark,988063140,67728730,62921110,223417170,0,1342130150,1997
clermont,1551023780,73265580,76792390,469308700,0,2170390450,1997
clinton,240725190,69999920,27799370,65630790,0,404155270,1997
columbiana,616659000,69111260,34073790,122197120,1692780,843733950,1997
coshocton,206754030,64734770,37533770,43394330,4428950,356845850,1997
crawford,265510880,67149530,23023100,47637200,0,403320710,1997
cuyahoga,14682593760,4396150,1106530240,5038666770,0,20832186920,1997
darke,361486020,114680010,25639480,58100610,0,559906120,1997
defiance,248041710,59719410,17871900,48540160,0,374173180,1997
delaware,1605269550,91980710,56940470,221948820,13080,1976152630,1997
erie,851918660,51552000,44499360,201084470,19380,1149073870,1997
fairfield,1155546280,111285970,32075750,200021110,921010,1499850120,1997
fayette,168400770,79415260,12132870,39643170,2960,299595030,1997
franklin,9666899280,80805670,922346830,4060010590,0,14730062370,1997
fulton,312110000,74326840,39955270,54643170,110,481035390,1997
gallia,129598920,43542480,3308570,76627300,436120,253513390,1997
geauga,1272198890,184352790,44474130,112535460,1873290,1615434560,1997
greene,1593078840,91028010,40159480,353148230,0,2077414560,1997
guernsey,195006740,40872280,10359520,45876510,2996800,295111850,1997
hamilton,8368021290,27354860,728436430,2960298510,0,12084111090,1997
hancock,564428860,100325980,68604710,134388150,0,867747700,1997
hardin,133905870,72285660,13265570,28901580,0,248358680,1997
harrison,68176380,34094490,7361730,14290880,2853350,126776830,1997
henry,190514150,70920170,14671580,22807000,0,298912900,1997
highland,209174660,74395290,7071700,37947800,0,328589450,1997
hocking,167039060,20619360,8921690,20012740,2524380,219117230,1997
holmes,164508710,120030930,25232770,40126540,6155650,356054600,1997
huron,393417070,81171720,31715780,80889670,26650,587220890,1997
jackson,132302120,35245940,17214850,32551710,350300,217664920,1997
jefferson,386866590,39443030,56761930,78885250,1398290,563355090,1997
knox,363096170,94761360,17416620,57595110,948720,533817980,1997
lake,2802755760,59386250,232959910,654691150,204510,3749997580,1997
lawrence,266728070,33647350,8433200,52563900,645580,362018100,1997
licking,1304995100,128572730,58731450,239106190,1515830,1732921300,1997
logan,347694990,68149200,26942140,66011450,0,508797780,1997
lorain,2701623520,82272980,163683600,486487710,111130,3434178940,1997
lucas,3554804800,54882500,226338680,1170173700,0,5006199680,1997
madison,255215760,71495380,15559220,41808850,0,384079210,1997
mahoning,1799400250,88227270,82677710,462822700,6376690,2439504620,1997
marion,354049440,61742560,35000620,91491590,4730,542288940,1997
medina,1735669880,185188030,72234340,278061240,1354320,2272507810,1997
meigs,70588950,34577960,23912160,12946300,4368280,146393650,1997
mercer,285553880,106596630,18011190,49906740,1900,460070340,1997
miami,933364190,83962040,77640650,146073950,0,1241040830,1997
monroe,51802410,36380510,20533650,7671880,3576440,119964890,1997
montgomery,4849771830,79709170,299575040,1404829190,0,6633885230,1997
morgan,55839530,42757650,5298350,18608800,2167430,124671760,1997
morrow,173523500,53741790,6166660,17935000,1146200,252513150,1997
muskingum,508162250,72896860,26817420,140324460,9043930,757244920,1997
noble,46342800,39447230,2622150,8576570,3526940,100515690,1997
ottawa,617007900,53389650,62918890,129548080,0,862864520,1997
paulding,94395260,43377400,7542340,11198320,0,156513320,1997
perry,137414140,38904340,7034940,20375700,4417170,208146290,1997
pickaway,338780640,79619240,27413670,59137270,713570,505664390,1997
pike,94501240,32956740,1635570,20293250,14900,149401700,1997
portage,1299040790,109403530,84019790,234021120,7389100,1733874330,1997
preble,277545910,85421840,20663550,33671250,0,417302550,1997
putnam,213508190,87422260,10872220,24120600,0,335923270,1997
richland,828774870,64688860,78822020,229153310,79650,1201518710,1997
ross,364216020,69351700,39875870,84754650,32110,558230350,1997
sandusky,451317010,88351620,38617700,94691890,26600,673004820,1997
scioto,303357870,44571720,10706790,84557210,29250,443222840,1997
seneca,318034660,87707550,28844350,61639730,5030,496231320,1997
shelby,347626120,81345700,54537090,59840020,430,543349360,1997
stark,3153562820,149293820,170992400,792029870,8369270,4274248180,1997
summit,5790344810,73985920,269636740,1478703240,3802860,7616473570,1997
trumbull,1516368310,134462370,117034880,344742850,6750940,2119359350,1997
tuscarawas,532641190,109855340,45437730,139520740,6100740,833555740,1997
union,270373290,93791060,60762060,54270570,0,479196980,1997
van wert,181178640,65027940,15360590,29930890,580,291498640,1997
vinton,41566610,31294400,3807220,4882270,2470740,84021240,1997
warren,1639703300,105867350,61575500,352293060,0,2159439210,1997
washington,310552360,89806940,38701540,88255510,2834720,530151070,1997
wayne,842747310,119588420,77936730,156393150,5092840,1201758450,1997
williams,267033830,66326830,29247000,42277130,0,404884790,1997
wood,988086150,85322290,91398550,234449690,7950,1399264630,1997
wyandot,115185940,58552880,14329720,20110610,31010,208210160,1997
adams,110873390,53261190,52508680,20612450,0,237255710,1998
allen,747008460,73290910,67627520,199593270,0,1087520160,1998
ashland,354703450,61574900,21865130,57402100,295350,495840930,1998
ashtabula,611542520,146748850,47885250,146411790,1153330,953741740,1998
athens,275275060,52041650,5739450,96843060,1025600,430924820,1998
auglaize,349590190,58762740,32472190,65162700,0,505987820,1998
belmont,359004080,57711170,26240580,119892400,4611160,567459390,1998
brown,233296870,72504930,6628430,29567380,0,341997610,1998
butler,3103654940,96575520,344945290,652990870,0,4198166620,1998
carroll,192935970,78821060,9643110,24283790,1564220,307248150,1998
champaign,298353590,91429730,15930130,41185030,0,446898480,1998
clark,1147596560,84187800,64676070,243003730,0,1539464160,1998
clermont,1623539420,72054020,79263150,479499210,0,2254355800,1998
clinton,250459910,71221130,29058920,67002080,0,417742040,1998
columbiana,742420990,111224960,37850140,163046870,1554560,1056097520,1998
coshocton,210370130,64548670,35179360,45044560,3702990,358845710,1998
crawford,270108040,67168700,22399410,49768770,0,409444920,1998
cuyahoga,14839570010,5428860,1130037350,5192147730,0,21167183950,1998
darke,370933470,116050320,24877970,60357140,0,572218900,1998
defiance,257951350,60358110,18290290,49408730,0,386008480,1998
delaware,1761665570,90504490,61989040,260222990,13080,2174395170,1998
erie,874155120,52897660,44915590,203848700,19380,1175836450,1998
fairfield,1300821170,130836130,33025180,233113680,1192420,1698988580,1998
fayette,172944260,79895440,12348690,40780970,2960,305972320,1998
franklin,9964871450,75140900,970916480,4343598330,0,15354527160,1998
fulton,322435880,74946590,39410420,54966280,110,491759280,1998
gallia,135619170,45539990,4113270,77981470,434200,263688100,1998
geauga,1317352390,188324470,46137230,118409180,1741600,1671964870,1998
greene,1633665840,91419770,39209350,357990260,0,2122285220,1998
guernsey,196777690,38308720,10036510,48300360,2594140,296017420,1998
hamilton,8437289640,27129370,734211170,2998087980,0,12196718160,1998
hancock,665854850,124618350,67716350,156616340,0,1014805890,1998
hardin,139454650,74091930,13570530,30042280,0,257159390,1998
harrison,69598600,34273520,7518880,14522720,2759940,128673660,1998
henry,197566170,70702310,16465090,23302150,0,308035720,1998
highland,219780840,75454090,7100530,40230700,0,342566160,1998
hocking,204118470,26167740,9328930,23924760,1183350,264723250,1998
holmes,216270380,142409520,26894080,42793400,5732810,434100190,1998
huron,404325280,81796910,33480490,80780530,27060,600410270,1998
jackson,135465290,35436430,17307770,32919460,359540,221488490,1998
jefferson,391348220,39855270,56742620,80108070,1379480,569433660,1998
knox,376034660,96308130,18843310,58835020,794390,550815510,1998
lake,2855284810,59349750,247898500,675365790,159030,3838057880,1998
lawrence,358660110,45196880,9282250,66697050,582110,480418400,1998
licking,1384740090,130302200,59562790,258833310,1918130,1835356520,1998
logan,394020040,82261760,28223680,67446180,0,571951660,1998
lorain,2790117440,83127250,163476910,516928110,100030,3553749740,1998
lucas,3619647860,54318850,224776050,1192731260,0,5091474020,1998
madison,266079200,72015860,16601020,52592730,0,407288810,1998
mahoning,1839861420,88618670,84928830,486604380,6173860,2506187160,1998
marion,450691310,76485160,35727710,95213970,2590,658120740,1998
medina,1889450110,191343900,75598710,288489180,1295120,2446177020,1998
meigs,83117740,42100830,25207020,15671580,3015180,169112350,1998
mercer,296739560,109095150,18989710,52222130,1900,477048450,1998
miami,1062645260,98242120,77845040,157556010,0,1396288430,1998
monroe,62121110,42385210,21010410,8570640,3502460,137589830,1998
montgomery,4918882990,78122980,300851230,1471957510,0,6769814710,1998
morgan,57157110,42989650,5298350,18791400,1866870,126103380,1998
morrow,182471350,53753830,4780870,17518600,959310,259483960,1998
muskingum,520919850,73051370,27230390,140619870,7815090,769636570,1998
noble,46359260,39418730,2622150,8917840,3405410,100723390,1998
ottawa,630291470,53077400,62031280,131265700,0,876665850,1998
paulding,123038360,58141060,8957500,13903040,0,204039960,1998
perry,143725550,40779280,6751330,21244000,3980610,216480770,1998
pickaway,350792230,80815470,29272510,60997970,565280,522443460,1998
pike,97556850,33545690,1703690,23818470,14910,156639610,1998
portage,1347590320,108650100,84307390,247709080,7899850,1796156740,1998
preble,285653300,86597050,21211310,34895700,0,428357360,1998
putnam,221431330,88362470,11688800,26084190,0,347566790,1998
richland,845591270,65269120,79957360,233672660,62110,1224552520,1998
ross,431218060,84515060,40456890,90371780,12480,646574270,1998
sandusky,458907350,88753500,39149600,97502200,26600,684339250,1998
scioto,362647800,53639250,9767650,97469990,26070,523550760,1998
seneca,324676650,88591120,30300230,64848430,3510,508419940,1998
shelby,359988290,81798080,54605140,62084430,430,558476370,1998
stark,3228470530,147278880,190563500,820268220,8086850,4394667980,1998
summit,5930044840,74487860,271540790,1524052620,3846720,7803972830,1998
trumbull,1545133230,134499570,116341030,356309250,6777230,2159060310,1998
tuscarawas,695415660,123957330,59419080,175086590,5892440,1059771100,1998
union,337689460,112901860,66799330,56972050,0,574362700,1998
van wert,185444770,64996520,15192690,31384770,0,297018750,1998
vinton,43265970,31474430,3807220,4859820,2443110,85850550,1998
warren,1783025450,105017130,69190720,361434550,0,2318667850,1998
washington,406479180,83610220,39485280,105835390,2299620,637709690,1998
wayne,867380300,119703630,82315150,170218360,6636850,1246254290,1998
williams,274507960,67021800,30109070,43024670,0,414663500,1998
wood,1023386320,86314280,92116100,241914240,7950,1443738890,1998
wyandot,136289420,69829360,15062410,20598130,18120,241797440,1998
adams,113579390,53043690,52506720,20142950,0,239272750,1999
allen,760193760,72694170,70780350,209414990,0,1113083270,1999
ashland,435938070,75710500,21938640,59493920,242920,593324050,1999
ashtabula,733093020,160800150,51968420,150055480,1748030,1097665100,1999
athens,313782940,59225480,7267620,106337820,1024190,487638050,1999
auglaize,410684480,72277490,34786230,73675260,0,591423460,1999
belmont,367745730,59371500,26792960,123396210,4918800,582225200,1999
brown,245706510,74188330,6628430,30233870,0,356757140,1999
butler,3507189940,122027300,405243890,728978940,0,4763440070,1999
carroll,198745740,79921670,9660170,24891240,1382740,314601560,1999
champaign,305890310,90988130,15457750,40107240,0,452443430,1999
clark,1164663530,85596790,65744800,244979930,0,1560985050,1999
clermont,1867910070,83721000,86162370,501395510,0,2539188950,1999
clinton,324260080,97620810,35935830,76194280,0,534011000,1999
columbiana,749116260,110075730,37888770,144092900,1427880,1042601540,1999
coshocton,215341210,65473650,35318200,47155740,3532820,366821620,1999
crawford,273476580,67191640,22961120,50288980,0,413918320,1999
cuyahoga,15003245360,6019790,1124816230,5353049740,0,21487131120,1999
darke,457272420,146512810,26140090,72955570,0,702880890,1999
defiance,309688040,80413990,19858250,51250010,0,461210290,1999
delaware,2180029050,114161760,75701110,338074370,13890,2707980180,1999
erie,890433930,52473100,45787920,205584800,19380,1194299130,1999
fairfield,1351374720,133045710,33651400,247924910,1858010,1767854750,1999
fayette,178250760,80141250,13033810,41535910,2960,312964690,1999
franklin,11650229630,69234520,1073661050,4886274030,0,17679399230,1999
fulton,386672040,87950450,39881730,57334350,110,571838680,1999
gallia,159261620,53321120,3575000,83743290,382210,300283240,1999
geauga,1567520840,234061780,57950010,144327420,1570630,2005430680,1999
greene,1737813930,111645820,40208830,380342110,0,2270010690,1999
guernsey,202451580,38927660,10668890,48459630,2090910,302598670,1999
hamilton,9920385960,37881910,781105010,3436051420,0,14175424300,1999
hancock,686346420,126394800,71832620,157149560,0,1041723400,1999
hardin,170542420,94069870,14489200,32451440,0,311552930,1999
harrison,80826280,41394960,8327830,15702420,2717110,148968600,1999
henry,234616000,92327680,18259120,23671560,0,368874360,1999
highland,229389730,77245430,7502430,40531330,0,354668920,1999
hocking,210142100,26709570,8927180,24928210,1092580,271799640,1999
holmes,221808790,146320530,26933270,44640540,4677230,444380360,1999
huron,417209540,82180730,32634580,83925220,25530,615975600,1999
jackson,161257350,41191540,16984120,42435210,361100,262229320,1999
jefferson,396801350,40699070,56841860,80463540,1301810,576107630,1999
knox,458566880,123779940,18716170,62817350,581210,664461550,1999
lake,2913618330,60326350,256814330,687937150,150540,3918846700,1999
lawrence,354794650,41607450,9147280,65882530,587010,472018920,1999
licking,1614147190,159519680,68948720,313941050,1769940,2158326580,1999
logan,404449040,83114500,28485310,68118120,0,584166970,1999
lorain,2872358850,83722020,167020450,541472580,97320,3664671220,1999
lucas,3691746200,54460620,225863410,1218428360,0,5190498590,1999
madison,327413300,91910080,21563980,46536470,0,487423830,1999
mahoning,2232256220,114815440,95474250,582014040,6474650,3031034600,1999
marion,457311190,76250360,36680250,96475440,4110,666721350,1999
medina,1983127650,195242400,77721780,308714590,1270210,2566076630,1999
meigs,84694630,41827030,24867190,15651440,2964670,170004960,1999
mercer,365501320,138074330,16719100,55399470,1900,575696120,1999
miami,1089110410,97094860,79881530,187356010,0,1453442810,1999
monroe,62676100,42843730,21010410,8567480,3385030,138482750,1999
montgomery,5409603470,91162040,318434850,1562184150,0,7381384510,1999
morgan,58843770,43354170,5410570,18936670,1605080,128150260,1999
morrow,263844730,77413260,5391700,24914220,737430,372301340,1999
muskingum,535012450,71422110,28583920,147508030,7474680,790001190,1999
noble,52617870,44432320,2618570,9116750,3283500,112069010,1999
ottawa,645944160,53000630,62526290,133161770,0,894632850,1999
paulding,125575460,58087420,8637660,14157240,0,206457780,1999
perry,182144920,51255160,6797360,23949930,3660260,267807630,1999
pickaway,425953100,104699230,30995710,72043770,334570,634026380,1999
pike,123945720,39547170,3293720,30637940,0,197424550,1999
portage,1395029800,109099360,89538380,260052520,6680410,1860400470,1999
preble,344686530,116473250,22461150,43962550,0,527583480,1999
putnam,268708890,112997730,12213320,28326780,0,422246720,1999
richland,1069867410,97660360,89209430,253463920,21830,1510222950,1999
ross,445921510,86586360,42707470,92293050,6980,667515370,1999
sandusky,463736180,86873130,47935420,99816350,26600,698387680,1999
scioto,363023020,55391550,9769910,97627800,26070,525838350,1999
seneca,427262880,123335180,35601420,77103340,3140,663305960,1999
shelby,413926790,98819640,55055930,66525660,430,634328450,1999
stark,3309842000,147342770,189607750,834718060,7793430,4489304010,1999
summit,6638930420,88052290,283007190,1630822330,3430270,8644242500,1999
trumbull,1826273630,174614110,122801110,407194540,6591880,2537475270,1999
tuscarawas,708855330,125110510,60301110,177835330,6382210,1078484490,1999
union,362031540,113719460,71834680,64917930,0,612503610,1999
van wert,211674170,82519970,15807290,31307020,0,341308450,1999
vinton,44507240,31965220,3842050,4901670,2425090,87641270,1999
warren,1948265650,103551200,73314530,379143660,0,2504275040,1999
washington,407445370,81452010,40101330,103518180,2513460,635030350,1999
wayne,978591840,135957690,84651110,171977750,8296510,1379474900,1999
williams,283413950,67460830,32725700,43208660,0,426809140,1999
wood,1319273340,114781040,117807600,324461980,7900,1876331860,1999
wyandot,139152860,71489120,15404350,20934400,12370,246993100,1999
adams,117349550,53020630,53064860,20875850,0,244310890,2000
allen,821744860,78826550,72450860,217189980,0,1190212250,2000
ashland,449190820,75984150,22182360,60842190,204100,608403620,2000
ashtabula,749460360,162730950,53766920,157904130,1648750,1125511110,2000
athens,324830600,59865050,7270760,109096750,893270,501956430,2000
auglaize,419496180,72112540,36686490,74582820,0,602878030,2000
belmont,443880580,70536130,30264720,153788740,4940540,703410710,2000
brown,297953790,86354510,6144600,37746170,0,428199070,2000
butler,3663494990,119685300,447527430,758235690,0,4988943410,2000
carroll,204367920,82728360,9392480,25980530,1251060,323720350,2000
champaign,314235710,91463220,15492330,42181510,0,463372770,2000
clark,1184976100,86451510,65128260,252095180,0,1588651050,2000
clermont,1951039280,82880490,84159510,518063230,0,2636142510,2000
clinton,336721310,98540980,38359350,77613720,0,551235360,2000
columbiana,765111770,109631780,38578220,145025960,1385360,1059733090,2000
coshocton,240200260,75031040,35107960,48383890,2897040,401620190,2000
crawford,337535860,77518920,23729380,54012100,0,492796260,2000
cuyahoga,16961073870,8499050,1198278190,6167744060,0,24335595170,2000
darke,467569010,146311700,27801530,73846440,0,715528680,2000
defiance,315858440,80858570,21605300,54008700,0,472331010,2000
delaware,2391282340,113114660,74684360,435118910,13890,3014214160,2000
erie,1024205700,56816190,45530500,229701720,19380,1356273490,2000
fairfield,1403433700,136678730,34837050,252822360,1814810,1829586650,2000
fayette,222780060,87769400,17620990,57377100,2960,385550510,2000
franklin,11972412180,72871530,1097608430,5051075180,0,18193967320,2000
fulton,394533800,88355220,40156600,58187670,110,581233400,2000
gallia,162458790,55155070,3578100,82524190,369520,304085670,2000
geauga,1623760470,235152670,58719120,150760610,1395980,2069788850,2000
greene,1775144330,115147070,41413690,403966640,0,2335671730,2000
guernsey,237851210,44617690,11334260,53343340,1801100,348947600,2000
hamilton,10030005540,34208050,798878970,3431862050,0,14294954610,2000
hancock,708189220,125679820,74013340,159905830,0,1067788210,2000
hardin,175238750,93852810,15887160,32659270,0,317637990,2000
harrison,81664540,41139420,8680000,15759710,2601460,149845130,2000
henry,240137970,91974640,19684960,24038810,0,375836380,2000
highland,283501900,95798580,9581380,51969950,0,440851810,2000
hocking,216387970,27411140,8924950,26951390,1178920,280854370,2000
holmes,232743510,148606210,26969800,47288690,3828410,459436620,2000
huron,513692510,104245840,35263910,92560430,25520,745788210,2000
jackson,166000100,41935970,17285090,47298220,361100,272880480,2000
jefferson,507166210,50645500,59799970,87445610,1328510,706385800,2000
knox,475717830,125392510,21895950,69422890,692510,693121690,2000
lake,3299854020,70313830,290612640,743506070,170880,4404457440,2000
lawrence,359678360,41552400,9201800,65776990,671250,476880800,2000
licking,1680443660,157505700,68727310,320409790,1785660,2228872120,2000
logan,416928210,84222420,29584900,69157500,0,599893030,2000
lorain,3444731480,94812010,193757640,597430070,81260,4330812460,2000
lucas,4644101950,76413060,244579900,1417383960,0,6382478870,2000
madison,337069710,93231610,22147420,49437920,0,501886660,2000
mahoning,2275541380,116217970,102394790,599093340,5739410,3098986890,2000
marion,468382470,76264290,36688020,103309060,2850,684646690,2000
medina,2067224000,193939190,84906360,324737930,1074420,2671881900,2000
meigs,87073880,41944810,25027180,15678350,2913730,172637950,2000
mercer,373235730,137155460,18797690,56610210,1920,585801010,2000
miami,1112635210,95972430,80893790,186314650,0,1475816080,2000
monroe,62879830,43888110,21010410,8724880,3351390,139854620,2000
montgomery,5481708000,88669530,329099750,1570270720,0,7469748000,2000
morgan,69474260,50828720,4677290,20051680,1330220,146362170,2000
morrow,276874300,76824040,5530970,26991330,693020,386913660,2000
muskingum,693317030,98287720,31609450,177487660,7047330,1007749190,2000
noble,54374800,44859940,2615640,9839130,3117790,114807300,2000
ottawa,775833190,59489080,64614190,141586920,0,1041523380,2000
paulding,129062930,58315920,8458340,14274670,0,210111860,2000
perry,187961350,51313590,6735240,24314940,2949630,273274750,2000
pickaway,436848950,104693100,30081750,74709970,252490,646586260,2000
pike,126008840,39231050,2780320,30087860,0,198108070,2000
portage,1660270260,132946390,111789070,318889520,5529090,2229424330,2000
preble,351938260,118330170,24676630,44211850,0,539156910,2000
putnam,278260420,112882730,12595060,29681370,0,433419580,2000
richland,1084501720,96480120,88450580,249902040,32130,1519366590,2000
ross,464625530,89895890,43966550,94774570,5170,693267710,2000
sandusky,543938310,96704530,46033890,102088470,26320,788791520,2000
scioto,368191170,56874250,9473400,98908800,36720,533484340,2000
seneca,434895130,124294600,35239090,78852950,6890,673288660,2000
shelby,424820720,100286420,55729750,69803160,430,650640480,2000
stark,3885198680,176728020,222748970,939290770,7994750,5231961190,2000
summit,6795835220,85268080,286926380,1671202270,639120,8839871070,2000
trumbull,1857117380,175098430,124450320,410886160,6274760,2573827050,2000
tuscarawas,720930020,126984840,60580730,182350490,5225750,1096071830,2000
union,393828530,114375180,71716220,70993560,0,650913490,2000
van wert,216150070,81849260,15786680,33814570,0,347600580,2000
vinton,50368150,36857400,3839820,5163370,2377070,98605810,2000
warren,2431454420,121636620,93786360,450435670,0,3097313070,2000
washington,411528610,80155600,40492260,107870350,2445750,642492570,2000
wayne,1001513970,136847050,85431830,175760760,6556130,1406109740,2000
williams,337154820,81933510,38322260,55050810,0,512461400,2000
wood,1360336710,113536060,119539220,331414820,7900,1924834710,2000
wyandot,142811980,74245490,16872190,21942720,7380,255879760,2000
adams,136551890,58623660,52858320,23451120,0,271484990,2001
allen,838093390,79180230,77677620,222712630,0,1217663870,2001
ashland,461079530,76870720,22745170,63151440,193070,624039930,2001
ashtabula,764690400,164377050,53332780,162542160,1625900,1146568290,2001
athens,334245130,61832840,6598170,110330480,838470,513845090,2001
auglaize,431135160,71888160,37442750,75380570,0,615846640,2001
belmont,450136560,70057270,28535320,154812140,5174100,708715390,2001
brown,309104380,85686540,6069990,39301690,0,440162600,2001
butler,3801579060,121314500,428495520,792209850,0,5143598930,2001
carroll,245689940,92489610,11227650,30305250,1421310,381133760,2001
champaign,376140230,95886410,19257690,49171480,0,540455810,2001
clark,1354727880,91837940,78555730,273186870,0,1798308420,2001
clermont,2037208210,83590400,88970270,540038320,0,2749807200,2001
clinton,348577020,98971360,39009610,83056240,0,569614230,2001
columbiana,873735070,123007310,38899690,145362550,1270950,1182275570,2001
coshocton,245544000,77020650,35182460,48476240,2640200,408863550,2001
crawford,341998140,77734290,24493720,54251390,0,498477540,2001
cuyahoga,17139588790,8956310,1260100440,6274959120,0,24683604660,2001
darke,476169980,145965100,28382800,76494890,0,727012770,2001
defiance,322566470,81623400,21944230,58062280,0,484196380,2001
delaware,2639263460,113802500,79100210,376885940,8780,3209060890,2001
erie,1040725900,57382950,46110920,241713280,19380,1385952430,2001
fairfield,1659955250,160831320,37573250,329107420,2089320,2189556560,2001
fayette,227429130,88061450,15188200,53179250,2960,383860990,2001
franklin,12301865270,71504340,1165334600,5204070870,0,18742775080,2001
fulton,404288500,89747000,38736020,59686670,110,592458300,2001
gallia,165994220,55646050,3608970,83407590,383370,309040200,2001
geauga,1670698590,238915270,63068680,158346740,1176980,2132206260,2001
greene,1822523550,112126850,44376530,435634470,0,2414661400,2001
guernsey,239730620,44740980,11997880,53705330,1705720,351880530,2001
hamilton,10124752550,33849160,802632600,3511723970,0,14472958280,2001
hancock,772829100,121173180,74567770,168993540,0,1137563590,2001
hardin,179329820,93386500,16393310,33764160,0,322873790,2001
harrison,82316430,40858150,8225430,15698410,2507620,149606040,2001
henry,245836480,91802690,20540160,25137980,0,383317310,2001
highland,293986020,95954310,9757250,53485330,0,453182910,2001
hocking,263710490,32035860,8964850,29771990,1103410,335586600,2001
holmes,264557180,159651540,27250040,53521380,3138710,508118850,2001
huron,519345600,102886490,37708240,94394010,106260,754440600,2001
jackson,169753440,41821830,17466650,58903390,377070,288322380,2001
jefferson,508906730,49392810,60899760,88751730,1327780,709278810,2001
knox,491377500,128404550,21937930,65334210,556650,707610840,2001
lake,3346621770,67749670,302495250,775206460,150780,4492223930,2001
lawrence,400345840,45309330,9618670,65854870,753980,521882690,2001
licking,1763569520,156178740,70982310,330187250,1256720,2322174540,2001
logan,500316990,88296800,34250880,82379290,0,705243960,2001
lorain,3541036490,92574340,192628690,617798230,75220,4444112970,2001
lucas,4709143190,74388840,255474630,1427032070,0,6466038730,2001
madison,348514910,93727370,21616610,53551330,0,517410220,2001
mahoning,2319405930,113626910,104565910,613597130,5586160,3156782040,2001
marion,563813210,77157190,35753490,119459420,3680,796186990,2001
medina,2473340280,231237860,108548160,428574300,1001260,3242701860,2001
meigs,102016150,49357260,25127990,15752650,2693600,194947650,2001
mercer,382092030,138528520,19857440,57778230,1760,598257980,2001
miami,1213995780,100419160,94036240,200284850,0,1608736030,2001
monroe,70344940,48408940,18968360,9687030,3270585,150679855,2001
montgomery,5557708910,87013600,313119000,1608947700,0,7566789210,2001
morgan,70692960,50977330,5422120,20524630,576680,148193720,2001
morrow,289420450,76680630,5484770,29168690,685950,401440490,2001
muskingum,710665300,95939930,31161430,182422550,6709160,1026898370,2001
noble,55474140,45620390,2620880,9804080,2954740,116474230,2001
ottawa,793206320,58708780,65301040,142416240,0,1059632380,2001
paulding,145000960,57314500,9253240,15244640,0,226813340,2001
perry,195668510,51954800,6747000,24469890,2799620,281639820,2001
pickaway,447728190,75764620,31106840,78886170,275140,633760960,2001
pike,128531970,39931340,2780870,27701100,0,198945280,2001
portage,1722827620,135064260,122959350,342299840,4686990,2327838060,2001
preble,358337880,119375980,26946860,45031150,0,549691870,2001
putnam,285249420,113619400,12814990,30856400,0,442540210,2001
richland,1101252350,96721400,90449450,258951630,44070,1547418900,2001
ross,538910310,95503550,46041480,107666130,2680,788124150,2001
sandusky,554044410,99345260,49364720,104803960,25620,807583970,2001
scioto,429349100,61263370,10070920,109169410,37420,609890220,2001
seneca,442567980,124811010,35798830,80361710,1140,683540670,2001
shelby,437939770,102446110,78061670,72601320,430,691049300,2001
stark,3961919230,178510480,222631900,945105030,7293900,5315460540,2001
summit,6957582900,86087000,302000530,1763873200,2371250,9111914880,2001
trumbull,1892715440,176786740,126487610,416209580,5468590,2617667960,2001
tuscarawas,807482850,139237910,62421900,198501950,4972090,1212616700,2001
union,479311700,126275770,72548850,87466710,0,765603030,2001
van wert,220792840,81656520,15989950,34488720,0,352928030,2001
vinton,51797870,36692460,3850800,5305160,2378680,100024970,2001
warren,2619852090,123011780,104323390,469472740,0,3316660000,2001
washington,471561410,90243740,40819170,117634990,2121200,722380510,2001
wayne,1028324590,140566600,87455210,180410200,6086490,1442843090,2001
williams,345193950,82247520,39869880,58969900,0,526281250,2001
wood,1391722320,112515410,124457960,337622210,6150,1966324050,2001
wyandot,177757180,79098470,20963630,24128660,6060,301954000,2001
adams,140669820,58376700,80991430,25938130,0,305976080,2002
allen,854508500,78609140,77902410,225231560,0,1236251610,2002
ashland,532645380,88667540,26316990,82795650,272740,730698300,2002
ashtabula,897654120,216605490,66258460,193288230,3330040,1377136340,2002
athens,409268590,74861290,7292450,126622190,842880,618887400,2002
auglaize,475052870,67878570,38845490,75154230,0,656931160,2002
belmont,454835300,70824830,29018920,155673510,5460910,715813470,2002
brown,322304370,87529010,6071620,40095730,0,456000730,2002
butler,4505797470,132240920,503771250,900423060,0,6042232700,2002
carroll,248471590,92213420,11003520,31063340,1848720,384600590,2002
champaign,383249560,96427180,18357750,49862750,0,547897240,2002
clark,1374165770,92887370,78504380,274264740,0,1819822260,2002
clermont,2343924760,85547930,97147310,610065790,0,3136685790,2002
clinton,389256490,94616730,39594840,87823150,0,611291210,2002
columbiana,888054710,123445720,39929610,142496250,1332000,1195258290,2002
coshocton,250303020,78639520,35061060,48775830,3507490,416286920,2002
crawford,347013180,78374380,24253080,57550970,1130,507192740,2002
cuyahoga,17319845760,8272760,1259015090,6204874070,0,24792007680,2002
darke,521831580,130603730,28592130,77322090,0,758349530,2002
defiance,348390950,76753560,22024560,73588240,0,520757310,2002
delaware,3197393960,105596900,94373910,457383340,11020,3854759130,2002
erie,1059140700,59180810,46293120,245871140,19380,1410505150,2002
fairfield,1715162330,160202700,37144880,339407790,3142470,2255060170,2002
fayette,232118420,88876730,22867590,57297280,2960,401162980,2002
franklin,14242587210,70796220,1213258970,5715316590,950,21241959940,2002
fulton,467356050,91842140,46746250,72898000,110,678842550,2002
gallia,184414910,62144550,3810990,85115130,387360,335872940,2002
geauga,1871807360,268065720,66505370,171858470,1676540,2379913460,2002
greene,2131077160,119178480,45717490,487557770,0,2783530900,2002
guernsey,243407660,45141840,12266260,59719350,2012920,362548030,2002
hamilton,11350856200,37705520,856460010,3829020470,0,16074042200,2002
hancock,796262040,119021250,75056890,177251930,0,1167592110,2002
hardin,206655030,84048540,16784520,34194190,0,341682280,2002
harrison,96785680,44371380,8962290,16201470,2675490,168996310,2002
henry,277613230,82176600,17339460,29101550,0,406230840,2002
highland,302436630,96614790,9974010,52613930,0,461639360,2002
hocking,272987770,33075290,7950250,31958070,1261530,347232910,2002
holmes,275410790,162831080,27575090,57403700,3920910,527141570,2002
huron,531392450,103431710,37962310,94702320,46420,767535210,2002
jackson,190676410,45431160,17117840,53279600,378200,306883210,2002
jefferson,511548590,49787790,60385000,92264720,1338680,715324780,2002
knox,557743580,145418660,24944090,80915110,777830,809799270,2002
lake,3406569990,67749170,313734600,799298020,204380,4587556160,2002
lawrence,407404150,45468940,10239610,67841500,944340,531898540,2002
licking,2093691620,170398260,77592570,350248610,1607080,2693538140,2002
logan,511083940,89280780,40632530,83417330,0,724414580,2002
lorain,3674797720,94127580,196409620,646518610,95310,4611948840,2002
lucas,4792621610,71184650,245113390,1465118930,0,6574038580,2002
madison,408487440,91517930,20829040,60474700,0,581309110,2002
mahoning,2362438430,108514710,110654210,617385390,7312090,3206304830,2002
marion,566537980,76992960,36311750,119830230,2720,799675640,2002
medina,2583947690,232818220,118678460,428200310,1006450,3364651130,2002
meigs,104539830,49757550,25151090,16213750,2825110,198487330,2002
mercer,399617630,129650610,19669660,59953600,2320,608893820,2002
miami,1237857080,100024280,95290110,202009830,0,1635181300,2002
monroe,70826600,49470800,18940950,9821060,3603010,152662420,2002
montgomery,6332724980,86577760,327844000,1801956130,0,8549102870,2002
morgan,72119890,51325080,5422120,21023470,1174090,151064650,2002
morrow,330076310,74537250,5692160,31780970,818970,442905660,2002
muskingum,726507090,95905300,31300160,186581160,8020150,1048313860,2002
noble,65557370,53616920,2701470,11454440,3180400,136510600,2002
ottawa,811801970,58824190,65478430,145368570,0,1081473160,2002
paulding,148685770,57582860,9927360,16330810,0,232526800,2002
perry,230679760,53863410,6720720,25067700,3004030,319335620,2002
pickaway,504279330,97840530,30646410,81882720,250150,714899140,2002
pike,147550380,42142590,2725900,27996670,0,220415540,2002
portage,1782085790,134451320,130511890,346677140,6017080,2399743220,2002
preble,411828580,117867370,28507350,45597340,0,603800640,2002
putnam,314567130,103876260,12713270,30456250,0,461612910,2002
richland,1223451420,100715710,89016770,257389140,41270,1670614310,2002
ross,549169740,97091200,46400190,106643040,2960,799307130,2002
sandusky,564702420,98465750,49165320,104622720,24850,816981060,2002
scioto,435292690,64472210,10096510,112349820,41430,622252660,2002
seneca,482668110,118476760,37101390,83151640,5830,721403730,2002
shelby,476719980,98315030,82202030,72382710,430,729620180,2002
stark,4047655140,179451920,225726220,931348230,8712990,5392894500,2002
summit,7964245140,95639180,333127690,1999661710,2607890,10395281610,2002
trumbull,2073965240,194678950,128037290,417227960,6653240,2820562680,2002
tuscarawas,822795750,138876020,63644480,201343270,6106040,1232765560,2002
union,509544740,128972800,80636990,92567650,0,811722180,2002
van wert,246215470,71858750,16107250,33320350,0,367501820,2002
vinton,54290330,37567900,3810050,5374420,2340150,103382850,2002
warren,2818931220,125860560,110816370,480583340,0,3536191490,2002
washington,475815920,89711270,41146780,122569590,2490490,731734050,2002
wayne,1171014140,156885030,93993370,214373460,6927530,1643193530,2002
williams,351719300,82161300,40326530,58565430,0,532772560,2002
wood,1498945170,105927140,129282230,365450790,5800,2099611130,2002
wyandot,181390000,80113450,20494460,24218670,5130,306221710,2002
adams,149700330,60062300,60707070,26720190,0,297189890,2003
allen,1029902400,77062500,82960420,266084690,0,1456010010,2003
ashland,546021840,87303680,26532310,81841280,185650,741884760,2003
ashtabula,911003930,217495530,67163310,194537930,3842720,1394043420,2003
athens,414432630,75707480,7715360,131048030,613850,629517350,2003
auglaize,485127490,67991960,40247440,75432090,0,668798980,2003
belmont,497325350,78170310,31427500,163592500,5167400,775683060,2003
brown,377002100,91008730,6397020,43814500,0,518222350,2003
butler,4628584110,133679480,489284160,922891860,0,6174439610,2003
carroll,252831700,93739610,11398480,32194320,1889050,392053160,2003
champaign,392442150,97080720,18007700,50515740,0,558046310,2003
clark,1396825020,95235350,78996590,297280220,0,1868337180,2003
clermont,2436124040,83523660,102053240,617869230,0,3239570170,2003
clinton,399704830,94996730,42221200,102715980,0,639638740,2003
columbiana,913237820,127464250,40664490,151009270,1458360,1233834190,2003
coshocton,284727930,88781780,37679010,57522920,3613320,472324960,2003
crawford,397579800,76538680,25659020,62345300,1130,562123930,2003
cuyahoga,19178387880,8537600,1280452640,6363695940,304480,26831378540,2003
darke,532028250,130964580,28096880,78485000,0,769574710,2003
defiance,355896230,77678100,22326800,71399020,0,527300150,2003
delaware,3488476800,101039680,109567400,480405930,10410,4179500220,2003
erie,1265766520,61322370,47596680,286259610,19380,1660964560,2003
fairfield,1792685100,160730680,37798620,341779060,2348540,2335342000,2003
fayette,253393360,79516890,18748430,65501400,2960,417163040,2003
franklin,14664144280,70652220,1208593860,5810728420,110,21754118890,2003
fulton,481462830,92414850,51729980,76151600,110,701759370,2003
gallia,187466460,62853530,3783780,102528330,447960,357080060,2003
geauga,1927097810,271376550,70427890,185113820,1731010,2455747080,2003
greene,2187513240,122549880,44706730,495618040,0,2850387890,2003
guernsey,294695500,52251870,17431430,71026590,2271810,437677200,2003
hamilton,11423712810,37851600,869277600,3882535430,0,16213377440,2003
hancock,823179640,119788580,72709060,191408740,0,1207086020,2003
hardin,211386920,84286800,17125000,34514720,0,347313440,2003
harrison,99575110,43877180,8931090,16213820,2642410,171239610,2003
henry,284552600,81871680,17447190,31849380,0,415720850,2003
highland,342599600,97532980,10934520,58004110,0,509071210,2003
hocking,283523590,33489540,7550890,32178170,1162850,357905040,2003
holmes,288639010,164634600,28820650,64139320,4058300,550291880,2003
huron,605962410,100876120,38831260,100490340,195160,846355290,2003
jackson,194131660,45364730,17157300,53843210,371990,310868890,2003
jefferson,549959400,56097800,61138710,105190510,1323070,773709490,2003
knox,574563710,146206830,25354350,85455470,823140,832403500,2003
lake,4107247250,77264450,331071300,860291990,218940,5376093930,2003
lawrence,417844910,45615980,10852800,69477280,1248440,545039410,2003
licking,2156898890,195385630,72359560,362710530,1705330,2789059940,2003
logan,522473060,90565690,40936660,87909810,0,741885220,2003
lorain,4135620250,101367980,204732540,714071050,88380,5155880200,2003
lucas,5568704340,71606490,246649010,1544457350,0,7431417190,2003
madison,422384060,93884680,20978120,64924080,0,602170940,2003
mahoning,2406430790,108027090,111945970,631949960,7717890,3266071700,2003
marion,575684080,78346310,36742510,119573500,2720,810349120,2003
medina,2724567120,213479150,120198640,442012210,1007130,3501264250,2003
meigs,107489820,50688850,25151090,16625820,2990370,202945950,2003
mercer,409320000,129630780,19963050,60606850,2320,619523000,2003
miami,1265910230,99907550,95552930,206669420,0,1668040130,2003
monroe,71988550,50872130,19077580,9952930,3756540,155647730,2003
montgomery,6413336120,85624950,321968810,1823766680,0,8644696560,2003
morgan,81705590,57242940,4774330,20809640,1217470,165749970,2003
morrow,343384830,79286370,6056370,33821030,791490,463340090,2003
muskingum,787838320,101349500,31620470,206188490,9333540,1136330320,2003
noble,67118340,53574380,2701470,11432810,3679150,138506150,2003
ottawa,967194670,59357360,65865670,161916680,0,1254334380,2003
paulding,150791470,57883860,10140700,16600360,0,235416390,2003
perry,235458120,56009470,6703650,25717550,2746860,326635650,2003
pickaway,531081320,98307110,30738930,81709200,253510,742090070,2003
pike,148102880,43519950,2726020,28483780,0,222832630,2003
portage,2048148750,152653920,135843470,363370530,6210600,2706227270,2003
preble,419516590,117764510,28714060,46620640,0,612615800,2003
putnam,322775480,105621450,13163470,32309140,0,473869540,2003
richland,1243754840,102473820,91271920,262034710,104750,1699640040,2003
ross,561472240,98275760,46400190,109296210,1230,815445630,2003
sandusky,659378340,85046970,56246660,112697790,24850,913394610,2003
scioto,440845370,67534590,10363750,113017730,45580,631807020,2003
seneca,487921470,120843180,37545570,81785870,3830,728099920,2003
shelby,487496400,99070690,85947810,78271700,430,750787030,2003
stark,4621029050,196371480,228076500,981706380,9697620,6036881030,2003
summit,8072479910,93018370,334234550,1992553450,2603980,10494890260,2003
trumbull,2101760720,195922940,128413820,418658640,7636960,2852393080,2003
tuscarawas,844707450,139957730,64327810,202008920,6534020,1257535930,2003
union,538710150,128572430,82198590,96963620,0,846444790,2003
van wert,249904100,71380800,15447020,33183090,0,369915010,2003
vinton,64122510,41345420,4292440,6419360,2354960,118534690,2003
warren,3261904430,137864440,122592300,502635470,0,4024996640,2003
washington,490952280,92883640,41061450,122878680,2483520,750259570,2003
wayne,1197500290,158585330,95075160,223134050,6955900,1681250730,2003
williams,374396330,74299240,40305590,61027730,0,550028890,2003
wood,1544300600,105869400,134076010,380196270,5600,2164447880,2003
wyandot,185766040,80698630,20833210,25109940,3630,312411450,2003
adams,169288010,64561620,59433190,31710970,0,324993790,2004
allen,1046470410,75032300,86033710,267973240,0,1475509660,2004
ashland,561591030,87363300,26547550,89286690,238230,765026800,2004
ashtabula,925600780,219899030,68908840,195801600,3222610,1413432860,2004
athens,421436160,75379760,7669640,129131360,623850,634240770,2004
auglaize,495046800,68649240,43715200,75770410,0,683181650,2004
belmont,506032050,79686650,32075130,163975670,5178280,786947780,2004
brown,389121770,93689670,5019850,44371310,0,532202600,2004
butler,4806840530,135661620,480510700,938646750,0,6361659600,2004
carroll,281465390,100861110,11485710,34130900,1856140,429799250,2004
champaign,428629560,85733490,19006770,53111880,0,586481700,2004
clark,1538248460,92851180,78487450,333111750,0,2042698840,2004
clermont,2525980780,82640620,105945230,625122630,0,3339689260,2004
clinton,411283950,95629940,42960140,105615600,0,655489630,2004
columbiana,1004806440,141131650,41298100,170376310,1399330,1359011830,2004
coshocton,289605550,87854990,37573570,59957350,3515310,478506770,2004
crawford,401470710,77610020,26089130,62140840,590,567311290,2004
cuyahoga,19376902940,9475410,1286412630,6636649410,650180,27310090570,2004
darke,538710040,132773300,27739450,79261290,0,778484080,2004
defiance,362862780,78133180,22496980,73372340,0,536865280,2004
delaware,3787189990,102848170,108116820,508775470,9870,4506940320,2004
erie,1278637330,63291410,49748890,291136470,19380,1682833480,2004
fairfield,2042983800,163735910,38112470,375187440,2133770,2622153390,2004
fayette,258416740,80089810,18958620,63905110,2960,421373240,2004
franklin,15106941840,69185370,1249717920,5833941850,0,22259786980,2004
fulton,492698590,93493680,59448970,77726550,110,723367900,2004
gallia,191499150,64884570,4107210,99807890,449550,360748370,2004
geauga,1967751680,273680880,67469720,193567870,1637870,2504108020,2004
greene,2249957990,123747470,45280700,506104050,0,2925090210,2004
guernsey,297110270,52761480,17519070,70831740,2578080,440800640,2004
hamilton,11543390560,38512690,872914610,3761655060,0,16216472920,2004
hancock,938517780,107403340,73057330,196024810,0,1315003260,2004
hardin,217395180,84679370,17129780,34293910,0,353498240,2004
harrison,102076590,43550400,8858460,16576550,2568060,173630060,2004
henry,293653940,81709340,17958000,32487600,0,425808880,2004
highland,355324380,99460450,10932040,59627130,0,525344000,2004
hocking,334619480,38948250,8624490,38131860,1531180,421855260,2004
holmes,334542710,165996670,35479200,75809560,3618410,615446550,2004
huron,620300800,100956110,39400960,100963880,389300,862011050,2004
jackson,199555140,45945860,16865340,55630890,383660,318380890,2004
jefferson,553778220,57322870,61373860,110566580,1336230,784377760,2004
knox,594348590,148847640,25032250,84509190,793100,853530770,2004
lake,4188830200,75725160,332078000,866610020,207690,5463451070,2004
lawrence,463325510,65132760,9565690,77265830,1378440,616668230,2004
licking,2252950300,194724030,73549780,376036590,1707000,2898967700,2004
logan,583001720,81999410,46576300,94856830,0,806434260,2004
lorain,4303883150,101503760,209880500,759730610,73840,5375071860,2004
lucas,5675301210,70947060,242502800,1598495620,0,7587246690,2004
madison,434690140,94959810,23256200,68592220,0,621498370,2004
mahoning,2447639640,108474080,113703190,631933460,8485610,3310235980,2004
marion,609169520,63556860,37030610,122520640,1160,832278790,2004
medina,3018510150,234347940,130157590,484083500,978580,3868077760,2004
meigs,119727140,63875160,20383870,18073780,2906870,224966820,2004
mercer,419896377,131708440,18141080,60619000,7070,630371967,2004
miami,1364309980,87306900,106018520,215764830,0,1773400230,2004
monroe,85507900,63575160,18196390,11552490,3709730,182541670,2004
montgomery,6499963560,86698020,324919410,1842965310,0,8754546300,2004
morgan,83274270,57464050,4774330,21232890,1335370,168080910,2004
morrow,355119460,78481040,5988970,33813290,1009320,474412080,2004
muskingum,804850760,102358880,32564660,213950850,9625700,1163350850,2004
noble,68315070,55016780,2701470,11344090,3775920,141153330,2004
ottawa,994745940,64463780,65850700,165266250,0,1290326670,2004
paulding,168030500,44300190,10557030,23127450,0,246015170,2004
perry,243471300,56551310,7824330,27126860,2757830,337731630,2004
pickaway,559461140,101535770,29981630,84154350,491730,775624620,2004
pike,149453200,44439550,8919970,29556140,0,232368860,2004
portage,2107652090,153496120,145957590,374697250,5928210,2787731260,2004
preble,426439480,118473320,28915760,48290820,0,622119380,2004
putnam,330807330,106150090,13192110,30771530,0,480921060,2004
richland,1265051280,106446320,90615970,263272790,271890,1725658250,2004
ross,626075380,93997470,47326310,121016730,1230,888417120,2004
sandusky,671322890,84126130,56997910,116272910,24850,928744690,2004
scioto,497248410,78554180,10333810,128312480,55890,714504770,2004
seneca,496276280,123537930,37304550,84000620,2550,741121930,2004
shelby,499619430,99653700,85965960,83717140,430,768956660,2004
stark,4718403160,194479100,244425080,991758420,9992470,6159058230,2004
summit,8239303970,92651120,342457100,2066864760,2872410,10744149360,2004
trumbull,2131937780,197432920,129076180,424216610,8110240,2890773730,2004
tuscarawas,956761890,150185550,66999760,214422970,6922090,1395292260,2004
union,631159250,120739980,93530160,113379600,0,958808990,2004
van wert,254657590,71514550,15759240,33421440,0,375352820,2004
vinton,65959530,41607790,4302620,6352180,2348560,120570680,2004
warren,3488834630,139226770,133904280,530794480,0,4292760160,2004
washington,548052950,98727360,43026790,148828790,2260240,840896130,2004
wayne,1227990410,158682980,98181190,240895870,6040920,1731791370,2004
williams,380197480,75064780,40571890,62609050,0,558443200,2004
wood,1586741210,106029190,136193820,393675630,5500,2222645350,2004
wyandot,209647050,68796800,20747720,28525260,3490,327720320,2004
adams,173332800,64002530,60335010,31657290,0,329327630,2005
allen,1065156870,75100630,89168160,286669830,0,1516095490,2005
ashland,613605480,86483600,25532060,93796310,316520,819733970,2005
ashtabula,1036841030,247107390,72696700,212744860,3983690,1573373670,2005
athens,463879490,85988540,8673100,142267910,609000,701418040,2005
auglaize,560409270,60599000,44014970,85143540,0,750166780,2005
belmont,517372760,80762040,32244120,165541530,5136520,801056970,2005
brown,401711850,96522130,5762930,47618560,0,551615470,2005
butler,5277538410,147682240,480044760,1025983560,0,6931248970,2005
carroll,285789500,101501590,11395620,34902100,2029360,435618170,2005
champaign,441293800,85969430,19228260,54119750,0,600611240,2005
clark,1558301350,95508460,83653320,352676210,0,2090139340,2005
clermont,2882566420,91059190,115089870,681655450,0,3770370930,2005
clinton,458266200,91384750,50721710,123425090,0,723797750,2005
columbiana,1019856110,140102380,41321070,171156410,1596280,1374032250,2005
coshocton,294781200,89046890,37621770,62347750,4111500,487909110,2005
crawford,405557150,77540980,27138240,63390840,390,573627600,2005
cuyahoga,19546856810,9598140,1283797530,6549019480,1009150,27390281110,2005
darke,591028440,122057870,28355250,87248450,0,828690010,2005
defiance,407769860,79386330,24548740,82713090,0,594418020,2005
delaware,4719024670,96011990,120769530,547490390,140130,5483436710,2005
erie,1301951500,61186190,51437170,302783920,53460,1717412240,2005
fairfield,2128648410,167557130,39206030,373336570,1648490,2710396630,2005
fayette,266057990,80696680,23690790,64949550,2960,435397970,2005
franklin,18300649410,63799920,1326665540,6122004020,0,25813118890,2005
fulton,536944880,89357020,62225930,82909510,110,771437450,2005
gallia,218739390,80188550,4292510,107565130,455730,411241310,2005
geauga,2242703040,297403560,79713080,224277780,1747470,2845844930,2005
greene,2477298440,126791080,45514610,538739110,0,3188343240,2005
guernsey,300589870,52890590,17579050,74275180,3164710,448499400,2005
hamilton,13854168230,62487380,923584370,4019878610,0,18860118590,2005
hancock,964344100,108135810,73071600,199242400,0,1344793910,2005
hardin,249925190,73250090,17027890,37097980,0,377301150,2005
harrison,119263330,55932020,9191600,18092370,2801650,205280970,2005
henry,325418200,71798350,19196560,39184020,0,455597130,2005
highland,368657750,100078750,12327740,62994110,0,544058350,2005
hocking,344144850,38567480,7801700,36278430,1532280,428324740,2005
holmes,341957920,173075300,37068690,80941150,3411660,636454720,2005
huron,632729760,101631410,39790630,105011400,255910,879419110,2005
jackson,250320860,63188110,19719920,69504570,386550,403120010,2005
jefferson,559630020,59269350,61425890,110645620,1328710,792299590,2005
knox,669696370,160751270,26424920,96424400,1168480,954465440,2005
lake,4280686230,76187100,344446890,871514690,323500,5573158410,2005
lawrence,469980830,63918790,9482940,79728120,1366950,624477630,2005
licking,2524543310,208928280,82627400,465521550,1806820,3283427360,2005
logan,595929260,82192780,47493510,93783460,0,819399010,2005
lorain,4483556240,100261860,217260280,797285390,85180,5598448950,2005
lucas,5780695190,72438190,246177210,1619218740,0,7718529330,2005
madison,512840860,83197110,26280230,76660800,0,698979000,2005
mahoning,2789685830,133489040,122762280,683779170,9772520,3739488840,2005
marion,617388260,64291640,37368230,126577640,2170,845627940,2005
medina,3120905420,235087730,132291390,527454320,983280,4016722140,2005
meigs,120722010,63581490,19824440,18853880,2999690,225981510,2005
mercer,495495410,122926200,19786590,68827900,4910,707041010,2005
miami,1399651160,89329530,107641660,233597650,0,1830220000,2005
monroe,86386670,64076750,18184440,12597260,3961720,185206840,2005
montgomery,7283400770,89270060,323769150,1976985230,0,9673425210,2005
morgan,86243150,57931960,4774400,21256850,1576940,171783300,2005
morrow,446745070,78155990,6584460,37954190,1084490,570524200,2005
muskingum,828789920,102566560,32894860,220298720,11520650,1196070710,2005
noble,76716190,64086300,2701470,11889150,3971130,159364240,2005
ottawa,1027849790,59812950,65963580,168735520,0,1322361840,2005
paulding,171558950,44498790,9327110,24358030,0,249742880,2005
perry,308684130,64423290,9332550,31839440,2916230,417195640,2005
pickaway,651873440,98321450,34973970,107385650,358500,892913010,2005
pike,184730150,51429650,9902790,30683970,0,276746560,2005
portage,2162925560,156622650,158394800,384242260,6408290,2868593560,2005
preble,488462380,117246300,32163100,51494280,0,689366060,2005
putnam,373330630,99147200,12241150,36693940,0,521412920,2005
richland,1451715670,115677570,85243990,291269390,264140,1944170760,2005
ross,635597130,95477370,49113300,122202390,600,902390790,2005
sandusky,685614810,82724910,57904290,121370880,24360,947639250,2005
scioto,501905660,78184290,9653820,126934490,28740,716707000,2005
seneca,551924040,114200620,36972800,97923310,4650,801025420,2005
shelby,555392090,96773530,90749640,86453210,430,829368900,2005
stark,4830545940,194846970,247618440,1028644070,10253630,6311909050,2005
summit,9053985410,102230830,360969710,2229658710,3205680,11750050340,2005
trumbull,2374001510,242756910,151872150,482559780,8980840,3260171190,2005
tuscarawas,977167440,151328660,68115950,217875580,7593770,1422081400,2005
union,679898750,124195170,99573480,118844700,0,1022512100,2005
van wert,280596510,58419690,15455910,36778320,0,391250430,2005
vinton,67471340,42596880,4172320,6418450,2370110,123029100,2005
warren,3720813740,140043940,135041970,552720030,0,4548619680,2005
washington,548622780,99905340,42555490,155581110,2585310,849250030,2005
wayne,1367717620,165586900,96847750,262288800,5648660,1898089730,2005
williams,385909210,74603720,42904050,65511870,0,568928850,2005
wood,1841325110,104117210,152756350,476940410,5550,2575144630,2005
wyandot,213891710,69257160,20900190,29170560,3490,333223110,2005
adams,178370820,64444230,60529920,31302220,0,334647190,2006
allen,1175276970,78488830,93074940,303254500,0,1650095240,2006
ashland,631399270,86689480,25709140,100197050,382600,844377540,2006
ashtabula,1052267110,249474570,72933350,217181840,3969090,1595825960,2006
athens,473458830,86264030,8569530,139855990,652500,708800880,2006
auglaize,570622910,60005210,47391170,85876530,0,763895820,2006
belmont,608214450,88784650,36293480,184584120,5177890,923054590,2006
brown,463716860,109431870,6235480,57113200,0,636497410,2006
butler,5443391690,150540790,483937920,1042174950,0,7120045350,2006
carroll,291310890,103626460,12126370,35117510,2569000,444750230,2006
champaign,450444380,90321940,23470850,61283040,0,625520210,2006
clark,1575527240,98254030,84925340,362644850,0,2121351460,2006
clermont,2959008280,89557260,117355620,675818250,0,3841739410,2006
clinton,472540360,91693690,67754040,123652040,0,755640130,2006
columbiana,1037135420,142203370,41976460,172707330,1644650,1395667230,2006
coshocton,329787290,101625290,35931200,67152980,4561710,539058470,2006
crawford,447151080,84098090,30150060,76442600,1440,637843270,2006
cuyahoga,21859784580,8414170,1297782340,7218387770,1071380,30385440240,2006
darke,600647760,119975180,29237190,88452630,0,838312760,2006
defiance,415776850,79650960,19815890,83062050,0,598305750,2006
delaware,5017046830,89797360,115688660,560367840,83370,5782984060,2006
erie,1478651920,67700750,46088770,352023240,65260,1944529940,2006
fairfield,2203005400,165786600,38447800,388508880,1520380,2797269060,2006
fayette,304390780,87699110,25207620,73694650,2960,490995120,2006
franklin,18738933560,56381790,1342587460,6293409440,0,26431312250,2006
fulton,550875730,89988780,74215550,81655920,110,796736090,2006
gallia,221850040,79022520,4474740,108090260,453130,413890690,2006
geauga,2286782860,298868250,81073020,224781660,1986750,2893492540,2006
greene,2552523790,132024740,46000660,543213320,0,3273762510,2006
guernsey,350862670,61284560,17893380,89001740,3194140,522236490,2006
hamilton,13921086690,60717310,922763300,4017470870,0,18922038170,2006
hancock,988747160,108982520,73464190,208054950,0,1379248820,2006
hardin,253409470,72445900,17806040,38462400,0,382123810,2006
harrison,119751240,55852340,8924840,18463260,2766540,205758220,2006
henry,330318170,71781870,19141310,40890130,0,462131480,2006
highland,419131350,100442320,14839880,72977790,0,607391340,2006
hocking,351969840,39428610,7964940,36613890,1276720,437254000,2006
holmes,353798500,172161790,38357930,81950440,3808280,650076940,2006
huron,688136510,105626430,37842980,116402000,444750,948452670,2006
jackson,253194580,63218600,21816410,66925090,387250,405541930,2006
jefferson,645929470,73265850,69738380,114176210,1362950,904472860,2006
knox,687341360,164727270,27243940,98188100,1463890,978964560,2006
lake,4827004710,83203260,360559340,979449630,533370,6250750310,2006
lawrence,478016940,63706520,9985610,78702010,1121520,631532600,2006
licking,2619346100,205424750,89835670,464321970,2132280,3381060770,2006
logan,605687500,82127720,69845370,95125680,0,852786270,2006
lorain,5135086010,121544010,226122730,882609520,27710,6365389980,2006
lucas,6477144600,74304660,293836400,1862825860,0,8708111520,2006
madison,525148660,85085640,28983060,78626130,0,717843490,2006
mahoning,2830456100,131990490,122797750,721228220,10291040,3816763600,2006
marion,630990510,65144040,38301770,137831710,1510,872269540,2006
medina,3219017690,233736200,140722710,539413280,1047620,4133937500,2006
meigs,123349250,63650310,19027260,18945120,3461240,228433180,2006
mercer,502024220,123847550,20893550,68491570,5780,715262670,2006
miami,1430966940,89186460,104865330,235307830,0,1860326560,2006
monroe,87323160,65606140,6056400,12582620,4154330,175722650,2006
montgomery,7371951660,84778360,328925180,1981994910,0,9767650110,2006
morgan,100764110,71614370,4205820,22082280,1709600,200376180,2006
morrow,462895910,77832170,6694390,36117340,1417700,584957510,2006
muskingum,957808490,133101080,33322690,249838290,11191320,1385261870,2006
noble,78458020,65458830,2739770,11935910,4161030,162753560,2006
ottawa,1218901750,61968480,65057740,184361250,0,1530289220,2006
paulding,174638930,45479120,10406270,20281970,0,250806290,2006
perry,310254750,64047080,9066890,32472020,3161740,419002480,2006
pickaway,665818540,112204940,25455360,100934290,321730,904734860,2006
pike,187327580,52987690,12141290,30472550,0,282929110,2006
portage,2429273920,174774140,184005560,426209750,7203290,3221466660,2006
preble,493630010,118013890,32828240,51242880,0,695715020,2006
putnam,381764530,100841650,12367980,36376360,0,531350520,2006
richland,1463477480,116149810,85514390,290849310,184250,1956175240,2006
ross,649425270,98649870,51295580,124333190,450,923704360,2006
sandusky,775963580,88484700,57860890,124342980,24360,1046676510,2006
scioto,507366420,78675330,9822690,129856650,28740,725749830,2006
seneca,557861940,116194940,36313350,100439180,6250,810815660,2006
shelby,566119740,97687700,95550200,86113530,430,845471600,2006
stark,5273516970,228346420,316069440,1197609080,13018960,7028560870,2006
summit,9218309910,100724150,368294190,2228479840,3491250,11919299340,2006
trumbull,2393810170,239212520,148228720,476849940,9636520,3267737870,2006
tuscarawas,1002722650,152590310,69061090,213787800,9140570,1447302420,2006
union,727001990,124557050,104104450,125227720,0,1080891210,2006
van wert,286043180,58587160,16183900,36869090,0,397683330,2006
vinton,76696280,49090770,3937700,6702920,2384910,138812580,2006
warren,4456833040,164147230,150373630,667883610,0,5439237510,2006
washington,551725100,100805190,42628480,161138220,2575630,858872620,2006
wayne,1396086910,170301280,98573650,261086070,6190380,1932238290,2006
williams,422277010,92054990,46102160,77580060,0,638014220,2006
wood,1882590700,97589910,162189410,464822230,5700,2607197950,2006
wyandot,217225190,69375910,21442500,31451040,3490,339498130,2006
adams,202501170,73380050,61129480,31660760,0,368671460,2007
allen,1190503400,77613290,101592180,314134830,0,1683843700,2007
ashland,644728940,86871070,27546920,103768370,311560,863226860,2007
ashtabula,1068224010,256758780,74296710,225150370,3216160,1627646030,2007
athens,483642930,88147980,6728650,143989050,607130,723115740,2007
auglaize,580076760,61129320,49590580,87648860,0,778445520,2007
belmont,619996270,89244950,36496450,188447610,4828530,939013810,2007
brown,470242060,111777300,6241160,56928750,0,645189270,2007
butler,5542767320,143915570,494761310,1087710780,0,7269154980,2007
carroll,320617600,116586650,13310000,38597800,4695550,493807600,2007
champaign,495764180,104896130,25249070,61378830,0,687288210,2007
clark,1688611200,118982120,98389100,411881010,0,2317863430,2007
clermont,3018971790,89422250,125144380,678610200,0,3912148620,2007
clinton,485276080,92364760,53068530,125532290,0,756241660,2007
columbiana,1112223820,167001840,43033910,175799210,1618720,1499677500,2007
coshocton,333889570,101838990,35995360,67142920,3700300,542567140,2007
crawford,450652280,84292740,29850140,76322050,1440,641118650,2007
cuyahoga,21964591260,8765780,1288299110,7141445090,1685340,30404786580,2007
darke,609583810,118603150,30400640,89995680,0,848583280,2007
defiance,424627120,79386665,21124880,88466290,0,613604955,2007
delaware,5224775120,83624910,126236000,556311670,47980,5990995680,2007
erie,1483431020,66349090,44927310,368532380,65260,1963305060,2007
fairfield,2409240430,184460870,41174720,462930580,1041480,3098848080,2007
fayette,311593150,87325360,24796170,74752830,2960,498470470,2007
franklin,18979914730,56300140,1356293350,6439569500,0,26832077720,2007
fulton,562010140,90239980,74623600,82423990,110,809297820,2007
gallia,225200400,79830370,4871080,109963160,439110,420304120,2007
geauga,2330463130,300451180,83535030,235768430,1715630,2951933400,2007
greene,2621964050,136040580,46684380,586503080,0,3391192090,2007
guernsey,357102960,62347540,18735700,84543780,2919870,525649850,2007
hamilton,14019425300,59606360,938632550,4015679960,0,19033344170,2007
hancock,1047353760,126608950,75101790,224638060,0,1473702560,2007
hardin,258465420,71391130,18496720,38579170,0,386932440,2007
harrison,120399160,56090460,9003750,18266360,2570480,206330210,2007
henry,336083080,71712430,19540940,41752850,0,469089300,2007
highland,429032000,100885700,14780360,69782680,0,614480740,2007
hocking,396281930,45727550,7172000,40005860,896890,490084230,2007
holmes,394331990,183221120,38576750,86840640,2986440,705956940,2007
huron,699839010,106598000,38390340,116941200,418310,962186860,2007
jackson,256192640,60271940,21822920,67778520,382920,406448940,2007
jefferson,649020960,73561340,69855230,119356450,1373480,913167460,2007
knox,705128260,169097950,30701320,85556950,1276950,991761430,2007
lake,4904761100,81021070,379090800,982150710,548440,6347572120,2007
lawrence,554760990,70741620,9444920,80644210,886570,716478310,2007
licking,2679347080,207771940,90716640,475984510,1968830,3455789000,2007
logan,707415970,99136670,70738920,105961820,0,983253380,2007
lorain,5262165710,116186700,234960660,906357240,63570,6519733880,2007
lucas,6512366630,70780870,277306080,1788125050,0,8648578630,2007
madison,536172380,86320420,29801430,81265810,0,733560040,2007
mahoning,2865146560,131823140,126776540,750680090,8295930,3882722260,2007
marion,689675800,74027630,41726210,147353770,700,952784110,2007
medina,3617934750,249247680,144463040,560637000,782670,4573065140,2007
meigs,137355270,68879470,18136110,20006870,3668080,248045800,2007
mercer,512585130,123776570,22237000,67076160,4920,725679780,2007
miami,1586451130,103266990,108205480,255958190,0,2053881790,2007
monroe,88065190,75517400,6136190,13198610,3664440,186581830,2007
montgomery,7458679150,86613820,323242980,1979947440,0,9848483390,2007
morgan,102245070,71848570,4225030,20627100,1389770,200335540,2007
morrow,478414670,77793200,6718590,36865390,1038760,600830610,2007
muskingum,969795440,128794340,32629620,250564160,9208520,1390992080,2007
noble,80116490,67114300,2639660,11986700,3689050,165546200,2007
ottawa,1247366550,62252010,66422960,186038060,0,1562079580,2007
paulding,186049330,54623690,11389370,19927580,0,271989970,2007
perry,328892770,64950360,9084070,32531590,2796710,438255500,2007
pickaway,684745620,113431850,25091720,104233650,275930,927778770,2007
pike,191932560,52557700,12149490,31426220,0,288065970,2007
portage,2487511890,171040860,177816690,439403510,5606190,3281379140,2007
preble,499855640,119862840,33453670,53586620,0,706758770,2007
putnam,389040960,102341230,15297070,37184340,0,543863600,2007
richland,1473364160,116463960,87751500,291667800,150960,1969398380,2007
ross,730867590,125216510,51957420,149817870,400,1057859790,2007
sandusky,783094810,87713730,59152640,126705370,24360,1056690910,2007
scioto,563367810,89987450,10246920,138212720,28740,801843640,2007
seneca,563033650,117868630,36429770,99598640,13900,816944590,2007
shelby,578335410,98315510,97869910,88995830,430,863517090,2007
stark,5346710350,227659490,301308230,1180414560,10280760,7066373390,2007
summit,9349139410,99996920,370829140,2237744300,2959870,12060669640,2007
trumbull,2412653400,240321040,147925660,477574000,7473540,3285947640,2007
tuscarawas,1081405570,161836160,69090300,229825520,9027890,1551185440,2007
union,862044640,151119570,105873780,151643230,0,1270681220,2007
van wert,290193140,58821550,15579150,37016150,0,401609990,2007
vinton,77639890,49513940,3847970,6658650,2377300,140037750,2007
warren,4660357260,164481080,157290120,708716400,0,5690844860,2007
washington,611163780,104649420,44682900,160418520,1936300,922850920,2007
wayne,1416591990,176290160,104491060,256206430,5034220,1958613860,2007
williams,428307670,91781330,47732390,77736670,0,645558060,2007
wood,1917350290,96526290,170070320,484987340,5700,2668939940,2007
wyandot,238098450,82810610,21036330,36548620,3490,378497500,2007
adams,205718800,74190070,63749630,42146520,0,385805020,2008
allen,1205141430,79115990,102765850,329572300,0,1716595570,2008
ashland,686091420,98844900,28904060,110468090,283840,924592310,2008
ashtabula,1148721640,292891720,79701890,241934880,3161140,1766411270,2008
athens,545167100,106977210,7349780,180241490,642470,840378050,2008
auglaize,621076570,88689090,50482800,88249620,0,848498080,2008
belmont,629171580,89642770,36169460,190160110,4678300,949822220,2008
brown,478462760,112927550,6175430,58701240,0,656266980,2008
butler,5828717190,164513520,582638200,1219914280,0,7795783190,2008
carroll,324038500,117146830,13738410,38773070,5343460,499040270,2008
champaign,500154800,101648450,26297120,66499870,0,694600240,2008
clark,1688676390,118379520,95701680,424815480,0,2327573070,2008
clermont,3225342160,100565560,118709270,698174190,0,4142791180,2008
clinton,507342770,119882250,53961180,130502510,0,811688710,2008
columbiana,1123821210,167503620,43502810,178568340,1774740,1515170720,2008
coshocton,336413930,103504670,37228590,68390750,3830530,549368470,2008
crawford,453018630,84936060,31320910,77200100,1710,646477410,2008
cuyahoga,22062470260,8402220,1280053780,7126064610,2182020,30479172890,2008
darke,642296610,157819250,32121630,90627050,0,922864540,2008
defiance,444748910,98395730,21227590,88840630,0,653212860,2008
delaware,5309092790,94005260,127996240,579497090,66010,6110657390,2008
erie,1497280370,66539410,44528520,377544500,47440,1985940240,2008
fairfield,2444797690,183040690,39615570,455355800,1041670,3123851420,2008
fayette,315074480,87139530,32519060,80409310,2960,515145340,2008
franklin,19153773240,51133990,1414161360,6719240500,0,27338309090,2008
fulton,573385600,123226000,74825680,95709990,0,867147270,2008
gallia,240314870,92936020,4919990,113672540,444340,452287760,2008
geauga,2364688280,301728290,84651700,237870440,2367340,2991306050,2008
greene,2862735140,163730960,51256400,668934840,0,3746657340,2008
guernsey,359671930,65016230,19029000,84769870,3124870,531611900,2008
hamilton,14206747100,59429190,990862090,4300439500,0,19557477880,2008
hancock,1059756910,127342290,75367130,225937780,0,1488404110,2008
hardin,272984590,104877590,18850000,38671880,0,435384060,2008
harrison,130716450,69139510,8929980,18662840,2549820,229998600,2008
henry,357629300,100159790,20580070,45586290,0,523955450,2008
highland,436810350,102257550,15258850,69476910,0,623803660,2008
hocking,403298230,46141690,7039720,40390400,725400,497595440,2008
holmes,403906980,185825050,39730380,87590930,3145690,720199030,2008
huron,707938540,106974460,40189980,119437580,346930,974887490,2008
jackson,271697830,63994250,19678260,68753250,384990,424508580,2008
jefferson,652761520,73338250,69580060,121754740,1892550,919327120,2008
knox,782345480,205461160,31231440,97290330,1416250,1117744660,2008
lake,4971190840,80473480,379702840,1010002640,693710,6442063510,2008
lawrence,556975630,72351100,9405920,81389030,799480,720921160,2008
licking,2713104570,224117900,97762410,481092940,2282710,3518360530,2008
logan,717545110,99578490,69494290,105583060,0,992200950,2008
lorain,5338537940,117667140,240284720,920773320,65210,6617328330,2008
lucas,6492631480,69900850,254405480,1869365670,0,8686303480,2008
madison,560609790,130839640,35924300,89280340,0,816654070,2008
mahoning,2892245540,133873060,132394360,775064360,9071090,3942648410,2008
marion,687305440,78892970,42988560,146502200,1640,955690810,2008
medina,3679486920,249192000,148688390,555939590,872470,4634179370,2008
meigs,140051580,68653390,18714750,20131750,2841070,250392540,2008
mercer,544518510,155624090,23615910,66539720,5320,790303550,2008
miami,1604527510,99903820,111061120,261028110,0,2076520560,2008
monroe,88849890,76292330,6991660,13252480,8577750,193964110,2008
montgomery,7388106350,102782630,324706170,2070913980,0,9886509130,2008
morgan,103939120,72447140,4366260,20665900,1558900,202977320,2008
morrow,493918930,99109050,7730010,38384930,1155600,640298520,2008
muskingum,980863000,130416110,34133970,260559950,7835380,1413808410,2008
noble,91719070,83273310,2861940,14703140,3900700,196458160,2008
ottawa,1270786930,61234130,64867510,190079120,0,1586967690,2008
paulding,189302540,55054750,10633620,21902380,0,276893290,2008
perry,351137180,74719540,9367450,32560150,2920160,470704480,2008
pickaway,705686340,144161190,29814780,105062260,446460,985171030,2008
pike,200899490,57704020,13537470,32114210,50810,304306000,2008
portage,2526470850,170723690,180195990,442092780,6387230,3325870540,2008
preble,515726910,151496100,34488550,56494550,0,758206110,2008
putnam,413419220,134585580,18835430,38530490,0,605370720,2008
richland,1482585150,128545520,83466230,292857300,133120,1987587320,2008
ross,742355410,125092000,47227430,151582200,310,1066257350,2008
sandusky,790423380,88549700,57911410,128913610,24360,1065822460,2008
scioto,565523610,91709060,11633380,139007070,7350,807880470,2008
seneca,593715690,158329380,36208710,96369780,8560,884632120,2008
shelby,602819440,125763370,100370930,90854400,0,919808140,2008
stark,5386436430,231369430,281399650,1192854320,12190290,7104250120,2008
summit,9324769970,103447810,394892630,2410912150,3438020,12237460580,2008
trumbull,2424269740,244169570,147508730,482516460,8424460,3306888960,2008
tuscarawas,1091498140,163292410,70586460,231116330,10383090,1566876430,2008
union,841183205,147101280,117598380,133433990,0,1239316855,2008
van wert,308875260,91858640,15162960,36955540,0,452852400,2008
vinton,78555380,49702010,3838330,6609690,2301040,141006450,2008
warren,4797578360,161262970,166244850,752880670,0,5877966850,2008
washington,614858010,104453610,48674590,162368090,2351440,932705740,2008
wayne,1512867820,205091060,111381640,279162970,4567240,2113070730,2008
williams,433301900,92682790,52767950,79603030,0,658355670,2008
wood,1938845270,135126240,182043800,495380860,5550,2751401720,2008
wyandot,241565780,83257940,21429780,34100330,4610,380358440,2008
adams,206683760,73406190,63443940,42462460,0,385996350,2009
allen,1197297660,112596410,107428760,360073690,0,1777396520,2009
ashland,690936360,99318770,29549260,113486790,316330,933607510,2009
ashtabula,1158672540,295345810,79757180,249075730,3731570,1786582830,2009
athens,549635230,106293120,7784630,180638260,635290,844986530,2009
auglaize,628413340,90452760,52490810,91183300,0,862540210,2009
belmont,635695840,97736060,33466130,183305540,4776570,954980140,2009
brown,476977820,142330800,6155050,59386760,0,684850430,2009
butler,5562241370,156939210,593824990,1249007880,0,7562013450,2009
carroll,321286120,121941000,13869520,39730300,5686930,502513870,2009
champaign,499087690,106564480,27373160,68312550,0,701337880,2009
clark,1660251230,118965100,95917230,409959840,0,2285093400,2009
clermont,3233757380,100751410,116061850,690839850,0,4141410490,2009
clinton,509325780,121068210,54195520,128439080,0,813028590,2009
columbiana,1133446440,169157680,44826690,180070840,2146070,1529647720,2009
coshocton,323489740,126926120,46364700,71213510,4455320,572449390,2009
crawford,422617190,113334930,29314450,77723580,0,642990150,2009
cuyahoga,20370857380,9005610,1272960530,7300242890,4689380,28957755790,2009
darke,646518020,157986440,33929810,88703970,0,927138240,2009
defiance,448998770,99717640,22531820,94520460,0,665768690,2009
delaware,5377009740,90738380,132656340,609694280,86550,6210185290,2009
erie,1492808990,78524980,45943990,382427090,45060,1999750110,2009
fairfield,2460503720,186001370,37731090,453636000,1358440,3139230620,2009
fayette,316544450,130097210,28854380,76320880,2960,551819880,2009
franklin,19206057660,51249740,1446987520,6747213020,0,27451507940,2009
fulton,574000760,122803960,76916100,95000920,110,868721850,2009
gallia,244567450,94269750,5149100,117487150,498280,461971730,2009
geauga,2379984910,302164620,82804440,235272730,4505010,3004731710,2009
greene,2889705220,159503200,50791170,679464730,0,3779464320,2009
guernsey,355607670,72163570,19185380,86962510,4885110,538804240,2009
hamilton,14216289480,52560260,998344930,4258435260,0,19525629930,2009
hancock,1072380470,128315990,76861880,226814310,0,1504372650,2009
hardin,275310900,104991400,20137700,39761770,0,440201770,2009
harrison,128805000,70088540,8119680,18575940,3097990,228687150,2009
henry,361119910,99732170,21714080,43106620,0,525672780,2009
highland,445745420,135644120,14382970,65190940,0,660963450,2009
hocking,410923680,46169610,7054730,40205390,825800,505179210,2009
holmes,412494020,187683340,37389570,88751840,3886710,730205480,2009
huron,714286810,141395650,38383820,120264590,542220,1014873090,2009
jackson,274489540,63865190,18516480,69508090,385200,426764500,2009
jefferson,629675710,72370010,69574240,122779930,1529940,895929830,2009
knox,786374560,205569150,33811730,94668620,2318680,1122742740,2009
lake,4509232840,64345060,375816740,1021280530,1807260,5972482430,2009
lawrence,561530810,73129100,9509200,80205470,701080,725075660,2009
licking,2740247720,227297020,99519030,495262320,2979120,3565305210,2009
logan,722929750,99269990,73056980,106350510,0,1001607230,2009
lorain,5085377210,115071630,236960100,923511900,70520,6360991360,2009
lucas,5660841710,78923550,261170820,1833869495,0,7834805575,2009
madison,564748630,130283790,38530400,86884760,0,820447580,2009
mahoning,2908763680,133309670,135839100,787253250,10911340,3976077040,2009
marion,688796350,79474690,41912790,146138510,1640,956323980,2009
medina,3715506870,245916650,158821790,575134880,1146320,4696526510,2009
meigs,142961580,69855070,18516320,20320260,2925730,254578960,2009
mercer,551015760,155148780,23861210,65295180,4500,795325430,2009
miami,1618040170,99645620,118581630,267675400,0,2103942820,2009
monroe,89435700,77012100,7064290,13409400,10666100,197587590,2009
montgomery,7371116010,101587400,329442090,2091738940,0,9893884440,2009
morgan,105243970,74371160,4173950,21329710,1853230,206972020,2009
morrow,498667140,98265300,7716880,38564440,1752690,644966450,2009
muskingum,994199010,140392120,39367460,263550470,8170520,1445679580,2009
noble,92129270,84017860,2861930,14471440,4541680,198022180,2009
ottawa,1308924380,77970320,65651100,194525860,0,1647071660,2009
paulding,192458540,56856620,10176700,20740280,0,280232140,2009
perry,355062340,75963450,9231820,34191820,3331130,477780560,2009
pickaway,712072490,143433290,23784150,103772530,568070,983630530,2009
pike,201983520,58562840,11686780,32806750,50810,305090700,2009
portage,2447808800,148774890,187687130,451695630,8069460,3244035910,2009
preble,518726970,153344480,34698740,56781750,0,763551940,2009
putnam,420254910,136118600,24628440,39169280,0,620171230,2009
richland,1479819840,129846250,84287020,293394830,129100,1987477040,2009
ross,749765260,126207440,48402340,152252120,360,1076627520,2009
sandusky,804719790,122009180,54494740,138805980,31610,1120061300,2009
scioto,572134380,95556060,11281190,137922920,7350,816901900,2009
seneca,594415750,158862570,35514810,97681450,17840,886492420,2009
shelby,609670160,127348410,103273690,93239200,0,933531460,2009
stark,5133450620,233753130,277387990,1194378900,14382780,6853353420,2009
summit,9347825320,102333550,382379330,2416790510,6728660,12256057370,2009
trumbull,2429605850,243996960,148562950,478046100,10002540,3310214400,2009
tuscarawas,1101093120,165683420,73403410,229632750,12546300,1582359000,2009
union,831409080,143644830,120470430,135748370,0,1231272710,2009
van wert,310836780,91629620,15485930,37110350,0,455062680,2009
vinton,85632750,59681920,4377240,7233630,2432570,159358110,2009
warren,4347719340,161896410,175957600,777696700,0,5463270050,2009
washington,616497110,106438590,48335170,162396900,2954560,936622330,2009
wayne,1520002750,207340380,108163070,279610200,6734980,2121851380,2009
williams,423243610,126643880,53161060,81375650,0,684424200,2009
wood,1948404840,136269810,195544410,510639340,4700,2790863100,2009
wyandot,243134280,82644680,21437420,34190300,7980,381414660,2009
adams,196465960,87123490,63755380,41571310,0,388916140,2010
allen,1200467910,115171490,103389920,356245770,0,1775275090,2010
ashland,693814570,99517490,31585760,113355720,489600,938763140,2010
ashtabula,1160325270,295302480,79171330,245936860,3731570,1784467510,2010
athens,551751560,106116150,6592870,179430660,975240,844866480,2010
auglaize,633589960,91388730,53782830,91904110,0,870665630,2010
belmont,641391240,99479990,33266960,183135630,5048340,962322160,2010
brown,478994630,143081480,6282710,58381120,0,686739940,2010
butler,5556093880,157828560,571617690,1147468360,0,7433008490,2010
carroll,326022360,130539820,13880350,40250120,5452350,516145000,2010
champaign,466118940,143229390,26090930,64846760,0,700286020,2010
clark,1569836850,151948440,95012580,416645520,0,2233443390,2010
clermont,3281499360,101571030,118706090,679491520,0,4181268000,2010
clinton,474561510,116841220,53613900,124285220,0,769301850,2010
columbiana,1100208610,196682560,50872740,199121850,2212350,1549098110,2010
coshocton,325512250,126759620,45701190,72173620,3938800,574085480,2010
crawford,423544190,112813800,30677820,79696260,1280,646733350,2010
cuyahoga,20380032210,8210250,1277341490,7458999450,6914960,29131498360,2010
darke,649680040,160043110,35562300,89410460,0,934695910,2010
defiance,451928360,99861300,22988040,87478890,0,662256590,2010
delaware,5406886580,89987300,133389140,603684110,61540,6234008670,2010
erie,1497521750,78870190,44870020,384543940,51930,2005857830,2010
fairfield,2371757930,221344380,38170480,442280140,1175930,3074728860,2010
fayette,316785270,131022030,28615460,75869460,2960,552295180,2010
franklin,19174212840,49525210,1462952600,6639594160,0,27326284810,2010
fulton,574522790,122803050,59378680,95306580,110,852011210,2010
gallia,248188270,95558890,5009350,117350050,446320,466552880,2010
geauga,2382200010,300668710,82947050,257332030,4792500,3027940300,2010
greene,2907938580,162266920,51410500,706398890,0,3828014890,2010
guernsey,357089330,73101110,19182780,86512820,4849760,540735800,2010
hamilton,14158842080,53208730,989563860,4074153470,0,19275768140,2010
hancock,1014614480,186304330,87301950,232491330,0,1520712090,2010
hardin,276897300,105307120,20159030,40904680,0,443268130,2010
harrison,125342160,73935760,7594000,18394920,2684520,227951360,2010
henry,364379890,98582280,21091360,43121560,0,527175090,2010
highland,447133210,136005640,13592640,65626820,0,662358310,2010
hocking,410958670,47200330,6815330,41168190,651870,506794390,2010
holmes,420676200,208868350,40882840,88690930,3686580,762804900,2010
huron,716140530,141512860,38336720,119646780,541470,1016178360,2010
jackson,275801550,64021870,18521920,69918400,385210,428648950,2010
jefferson,629132925,73064600,69808860,126175130,2858280,901039795,2010
knox,792114420,206015130,33023700,92126290,2364850,1125644390,2010
lake,4527478740,63251030,365996900,1074844570,1611620,6033182860,2010
lawrence,611434280,84250350,9224270,91782100,702830,797393830,2010
licking,2742319160,230724340,97061800,510157450,2717520,3582980270,2010
logan,723600280,136872140,72525990,105136360,0,1038134770,2010
lorain,5111409040,115861950,249680840,928277860,76350,6405306040,2010
lucas,5649127760,77445730,262249380,1784618784,0,7773441654,2010
madison,566088380,131236770,35760500,86367600,0,819453250,2010
mahoning,2912997570,132993450,140895290,779023100,10106530,3976015940,2010
marion,648857260,123381960,41180970,143376970,1640,956798800,2010
medina,3426336140,244015410,162317320,583741750,1086080,4417496700,2010
meigs,152657760,80057200,20204230,21110880,2895550,276925620,2010
mercer,557113380,155787940,25317870,66360440,4370,804584000,2010
miami,1577338020,134719120,120996480,270227960,0,2103281580,2010
monroe,92791120,86292530,6914670,13937150,7099340,207034810,2010
montgomery,7352260120,118757780,322853110,2045540190,0,9839411200,2010
morgan,106572190,74803160,4632500,21940310,1873870,209822030,2010
morrow,503306670,98888980,8085010,38710300,1925170,650916130,2010
muskingum,998615190,140924420,39359240,261962260,7847920,1448709030,2010
noble,93818040,83832230,2855770,14439550,4447140,199392730,2010
ottawa,1314627890,78033630,66077400,193433790,0,1652172710,2010
paulding,187257360,100579090,10825960,22951930,0,321614340,2010
perry,357362760,76327820,9141890,33787500,2946380,479566350,2010
pickaway,719602750,144753870,23439450,108893340,605660,997295070,2010
pike,204192570,59341770,12647310,32858960,0,309040610,2010
portage,2457260480,149648910,180373100,442254550,8716530,3238253570,2010
preble,519695100,153955220,35749740,58057900,0,767457960,2010
putnam,426295460,136737880,26487340,39066030,0,628586710,2010
richland,1472751870,130318160,77909480,289717180,100010,1970796700,2010
ross,737034320,162709260,43484300,153917440,290,1097145610,2010
sandusky,807660800,120771340,57103380,143700860,31670,1129268050,2010
scioto,603247900,113727480,11024480,135769030,7350,863776240,2010
seneca,596888140,155076180,33178040,98055400,18930,883216690,2010
shelby,614671190,128251990,102519150,91698940,0,937141270,2010
stark,5137492420,241313880,264618080,1181982120,13457930,6838864430,2010
summit,9361598220,101467420,383560890,2452978760,7414010,12307019300,2010
trumbull,2425190920,243407350,147359540,478971480,9198440,3304127730,2010
tuscarawas,1064852740,173330510,71570260,213550620,11891410,1535195540,2010
union,835256360,187658600,120357920,134567820,0,1277840700,2010
van wert,313348420,91967690,15245340,36542230,0,457103680,2010
vinton,82861060,60172990,4462710,7175220,2401050,157073030,2010
warren,4387334580,160170600,181573370,783478430,0,5512556980,2010
washington,625807460,118884910,48662940,173899140,2931980,970186430,2010
wayne,1527490640,210499020,108896340,277057340,7789740,2131733080,2010
williams,424592890,126602030,54174810,85988440,0,691358170,2010
wood,1951708390,136900500,187621330,511090140,4500,2787324860,2010
wyandot,230484170,121113690,21342870,34017060,7100,406964890,2010
adams,197664280,86873000,63416780,33941970,0,381896030,2011
allen,1203348670,111254120,109153550,343728750,0,1767485090,2011
ashland,631766980,122663670,31041840,106577610,401070,892451170,2011
ashtabula,1065967390,286709170,82232260,241161870,2866510,1678937200,2011
athens,546045450,112241750,6044330,178073140,1061070,843465740,2011
auglaize,595473030,150399240,53480070,94413790,0,893766130,2011
belmont,648846510,100580280,28464790,182831740,18933620,979656940,2011
brown,481239590,143384380,6228120,57624350,0,688476440,2011
butler,5314185780,181033080,515804900,1051605060,0,7062628820,2011
carroll,328417410,131546650,13420340,40427940,5447760,519260100,2011
champaign,467101040,144170030,27702770,65237310,0,704211150,2011
clark,1570063880,151465490,94427450,398447180,0,2214404000,2011
clermont,2972156140,112141760,100624130,584480880,0,3769402910,2011
clinton,448787280,167726260,25404410,134461950,0,776379900,2011
columbiana,1099990280,197003790,51186970,188567920,2120110,1538869070,2011
coshocton,327253070,125472740,45801030,70824030,3794720,573145590,2011
crawford,423332870,112727030,32030020,75774870,0,643864790,2011
cuyahoga,20295156550,8370120,1275283150,7489093650,7909250,29075812720,2011
darke,595848870,235936670,36471470,87329870,0,955586880,2011
defiance,421492390,149207360,23121420,85694010,0,679515180,2011
delaware,5134252590,120130890,128264270,583971470,51640,5966670860,2011
erie,1496060280,79184740,43754240,383878150,52410,2002929820,2011
fairfield,2381628400,219970830,38213330,440637390,1189380,3081639330,2011
fayette,315582290,129893590,28289890,76110100,2960,549878830,2011
franklin,17765108290,66506660,1412182580,6392019650,0,25635817180,2011
fulton,515301280,173888000,54119140,86001990,110,829310520,2011
gallia,254373450,111833770,5093670,119074710,458200,490833800,2011
geauga,2271959950,303733560,84714830,249962880,4364390,2914735610,2011
greene,2755081020,201869380,46632570,676233450,0,3679816420,2011
guernsey,358741240,74695560,19193280,87271610,4792490,544694180,2011
hamilton,12700328940,49068010,940474400,3827088790,0,17516960140,2011
hancock,1020071800,185217120,85357860,239762650,0,1530409430,2011
hardin,271175540,174030410,20595200,39668350,0,505469500,2011
harrison,118734650,89380580,7977130,17483260,2746780,236322400,2011
henry,352500010,169984720,20656150,41099500,0,584240380,2011
highland,448613300,136562210,13415270,64989080,0,663579860,2011
hocking,414914160,47582240,6695060,40997330,653660,510842450,2011
holmes,425364410,209751650,40897690,89359520,3149100,768522370,2011
huron,722116080,141259710,40848920,119374770,560750,1024160230,2011
jackson,271975100,72822540,14065270,68711640,390510,427965060,2011
jefferson,631283685,73492650,69664090,127673070,2859870,904973365,2011
knox,747655140,244198630,33636070,91518350,2619020,1119627210,2011
lake,4543110230,64556340,364433120,1005382670,1413150,5978895510,2011
lawrence,610863220,84390990,9038610,90550790,702830,795546440,2011
licking,2686145830,266702260,101496960,539017780,2881250,3596244080,2011
logan,725531220,137289210,74624540,103967850,0,1041412820,2011
lorain,5114587650,146443940,236420080,915295220,62330,6412809220,2011
lucas,5629044610,76387390,257474780,1732335220,0,7695242000,2011
madison,556223580,201519160,34605460,86148210,0,878496410,2011
mahoning,2694493850,147484610,143453370,753541580,9246740,3748220150,2011
marion,648740380,123746700,37913730,140151260,3210,950555280,2011
medina,3459944940,244572270,164943060,581692560,983600,4452136430,2011
meigs,153592320,80343450,20180570,21237000,6963590,282316930,2011
mercer,558031090,214691140,25172760,64139890,4370,862039250,2011
miami,1587212010,134233390,125725360,262720760,0,2109891520,2011
monroe,93203330,86750650,6912980,13911670,7552740,208331370,2011
montgomery,6814999820,143235880,292494510,1859223290,0,9109953500,2011
morgan,107310070,75360730,4642030,21572040,1695290,210580160,2011
morrow,485786580,126074890,9369440,40100220,2303300,663634430,2011
muskingum,1002960580,140499460,43883340,287852190,8375750,1483571320,2011
noble,89105970,89642070,2828990,14503990,4559200,200640220,2011
ottawa,1324296210,77545290,65222500,193431360,0,1660495360,2011
paulding,188433300,101175570,10472970,22709330,0,322791170,2011
perry,372272500,95967330,8447930,38879210,2508470,518075440,2011
pickaway,713611250,210114220,21551150,104123980,668370,1050068970,2011
pike,211255310,81685910,12321420,32914840,0,338177480,2011
portage,2465980100,150909850,178809750,437524160,7328720,3240552580,2011
preble,478039690,197775440,31570500,56576690,0,763962320,2011
putnam,428136930,210262670,23787460,36855710,0,699042770,2011
richland,1367741610,153099790,75516910,281197340,148600,1877704250,2011
ross,741797670,164004220,34828470,153182320,290,1093812970,2011
sandusky,810646050,120276770,62599090,144338640,31540,1137892090,2011
scioto,604285600,114047900,10543380,133799190,7350,862683420,2011
seneca,562001420,226400450,31141110,96243610,21150,915807740,2011
shelby,583876680,180543950,104158570,93254060,0,961833260,2011
stark,5137155040,249081960,261159770,1174029670,12011530,6833437970,2011
summit,8615634810,100333020,319696710,2116537710,6910490,11159112740,2011
trumbull,2243560990,259364000,126312180,499036840,7831110,3136105120,2011
tuscarawas,1068976910,173776270,72861530,212857900,10088380,1538560990,2011
union,841755600,189910140,120014110,135487090,0,1287166940,2011
van wert,303395200,160774570,16584590,35591220,0,516345580,2011
vinton,82938080,58050350,4386410,7092680,2404500,154872020,2011
warren,4434087030,158979990,175568190,771054250,0,5539689460,2011
washington,626554500,120227520,48067050,169233960,2600700,966683730,2011
wayne,1446248800,252050630,114374000,272153400,7126830,2091953660,2011
williams,426482240,126343780,55299140,79284460,0,687409620,2011
wood,1756020930,220387450,170411710,479733330,4250,2626557670,2011
wyandot,232145110,121703340,21523280,34052200,7100,409431030,2011
adams,198557350,87292410,63687670,33999620,0,383537050,2012
allen,1145212710,147720900,105032410,331140250,0,1729106270,2012
ashland,635245080,122311940,31822450,108108640,441760,897929870,2012
ashtabula,1069012560,285591960,85636940,222013920,3445120,1665700500,2012
athens,549746790,112408690,6049490,181359650,1080760,850645380,2012
auglaize,598226560,151764050,54506250,93837750,0,898334610,2012
belmont,698234580,123735320,29255680,188345070,20186700,1059757350,2012
brown,449217580,159428160,6273380,59535100,0,674454220,2012
butler,5319783940,176783030,510081920,1026034910,0,7032683800,2012
carroll,330415450,133064250,13433520,40764550,10979970,528657740,2012
champaign,467819840,146858700,29929950,61460460,0,706068950,2012
clark,1570275580,154808900,88879330,383910320,0,2197874130,2012
clermont,2981304820,111718510,100547010,581197010,0,3774767350,2012
clinton,449316140,167920480,24544390,122742520,0,764523530,2012
columbiana,1100856580,196388960,52550030,188737220,2178130,1540710920,2012
coshocton,328933910,139322120,46225590,69954270,3796140,588232030,2012
crawford,375753720,136615950,32231190,63136640,0,607737500,2012
cuyahoga,18491993250,9997690,1181319690,7178016160,7993580,26869320370,2012
darke,598005830,237319250,36580620,86635740,0,958541440,2012
defiance,423134180,149124720,24639150,87477350,0,684375400,2012
delaware,5182606230,115964370,124476400,587779800,53810,6010880610,2012
erie,1395597740,88143000,41302480,366938160,35400,1892016780,2012
fairfield,2390465760,220829080,45795970,443960230,1105810,3102156850,2012
fayette,287593160,167543130,27029680,110954100,2960,593123030,2012
franklin,17768002430,65614170,1418005220,6171797810,0,25423419630,2012
fulton,516879220,173902430,62850480,81540890,110,835173130,2012
gallia,255853840,111456270,5101030,118379510,467730,491258380,2012
geauga,2277481130,300807680,86404730,246154230,3893560,2914741330,2012
greene,2773598650,202336340,46777600,709116100,0,3731828690,2012
guernsey,364483560,89094730,16745170,89332990,4263940,563920390,2012
hamilton,12671138920,47003670,932520610,3717856860,0,17368520060,2012
hancock,1026292530,184067510,85295440,234429050,0,1530084530,2012
hardin,273091880,173361740,20410440,39571720,0,506435780,2012
harrison,118925930,88738270,7960320,17000070,40357640,272982230,2012
henry,352897240,169906930,21511810,41056450,0,585372430,2012
highland,413748840,159738080,12445360,63502930,0,649435210,2012
hocking,416894800,47764310,7078710,42025210,630930,514393960,2012
holmes,430334170,211494990,41347800,90696610,3005210,776878780,2012
huron,652355340,186550290,39684880,119365090,622900,998578500,2012
jackson,274260750,73747710,14522860,67831480,389390,430752190,2012
jefferson,620233485,90821460,69354440,132244690,4303790,916957865,2012
knox,750744200,246575580,34084930,93421600,3195370,1128021680,2012
lake,4145689190,61602310,315152490,867565230,1164770,5391173990,2012
lawrence,613355690,84569130,9205210,89600930,756290,797487250,2012
licking,2688685820,262884880,126389570,537031500,3204160,3618195930,2012
logan,732590470,138489640,73950850,105721040,0,1050752000,2012
lorain,4643719780,150541730,231521630,887101940,69530,5912954610,2012
lucas,4819015750,77517320,239175450,1637658120,0,6773366640,2012
madison,558395470,200958220,35706980,89842680,0,884903350,2012
mahoning,2704496180,146657570,145030840,761469980,8338600,3765993170,2012
marion,648403320,124032170,38113600,138694580,1720,949245390,2012
medina,3480706590,243283960,164470190,578080620,881150,4467422510,2012
meigs,154589670,80944630,20173170,21312700,6998820,284018990,2012
mercer,561003770,215615790,25100930,63777010,7390,865504890,2012
miami,1585981970,133745430,131220650,261032740,0,2111980790,2012
monroe,93447040,87179660,6910160,14256350,7085750,208878960,2012
montgomery,6805719580,137248360,280908380,1772338660,0,8996214980,2012
morgan,114422290,92539420,4014870,21724750,1678770,234380100,2012
morrow,487362970,126404970,9234410,38082450,2277290,663362090,2012
muskingum,916373130,166635580,46363010,287387740,8819670,1425579130,2012
noble,92208180,88775250,2823720,14745710,3886950,202439810,2012
ottawa,1241331820,90735070,60788660,184484000,0,1577339550,2012
paulding,189264590,101155610,10579800,22936420,0,323936420,2012
perry,372610500,95627770,7739660,36829300,2743400,515550630,2012
pickaway,716461910,210757710,23147560,96862760,669730,1047899670,2012
pike,209544000,82149600,5279610,32708270,0,329681480,2012
portage,2345695600,152742130,171520710,432169050,7212290,3109339780,2012
preble,477793560,198225110,27109670,54670640,0,757798980,2012
putnam,432114670,210212370,24415740,37214170,0,703956950,2012
richland,1352310960,151735310,71181170,272977560,84310,1848289310,2012
ross,744606830,165796840,36211340,154276850,20,1100891880,2012
sandusky,728180300,150848880,61974720,130177470,34400,1071215770,2012
scioto,605101360,114426300,10500840,132604930,7350,862640780,2012
seneca,563056400,226644800,31574550,95983390,20700,917279840,2012
shelby,584405310,182365550,104731900,89413320,0,960916080,2012
stark,4609353620,227936680,240013340,1027059900,11405710,6115769250,2012
summit,8616725870,101484160,329868560,2075009950,6841480,11129930020,2012
trumbull,2235589300,257244480,126522210,488745210,7310840,3115412040,2012
tuscarawas,1071752340,174475400,72198300,212947660,9085870,1540459570,2012
union,850477640,187468690,114328570,135469880,0,1287744780,2012
van wert,302681190,160300580,16352850,36160210,0,515494830,2012
vinton,83223150,63963040,4397120,6846700,2323110,160753120,2012
warren,4270415920,165544630,168507030,672514940,0,5276982520,2012
washington,626914250,121338090,48805270,172589790,2443610,972091010,2012
wayne,1450496720,256276830,128026040,261691100,6487600,2102978290,2012
williams,383889000,149302920,52313010,69196290,0,654701220,2012
wood,1761364510,222066050,172957730,493383570,2900,2649774760,2012
wyandot,233497590,122632670,21920920,33832320,9900,411893400,2012
adams,201499990,125319680,63410720,33910300,0,424140690,2013
allen,1145956620,148712550,111894550,328566810,0,1735130530,2013
ashland,637994160,123535500,31854320,108381860,408410,902174250,2013
ashtabula,1072294100,287181800,88445420,257374850,2965990,1708262160,2013
athens,551113620,113326700,6055640,184789820,933970,856219750,2013
auglaize,599939920,153786540,53644120,93606910,0,900977490,2013
belmont,702159930,123098270,26895390,194001760,23429380,1069584730,2013
brown,451349740,160193190,6264080,59789910,0,677596920,2013
butler,5292509310,175881570,500648900,1029218310,0,6998258090,2013
carroll,317511770,159604050,12922310,38993410,31287950,560319490,2013
champaign,463436080,240043080,28025370,59564870,0,791069400,2013
clark,1503325240,225142590,86152770,365415230,0,2180035830,2013
clermont,2994690110,112417370,100921220,580815910,0,3788844610,2013
clinton,449760040,168521100,23676780,121258110,0,763216030,2013
columbiana,1070270670,232119190,54537290,187017300,2215700,1546160150,2013
coshocton,329676530,140534310,45280400,68524570,3965320,587981130,2013
crawford,375055100,136984880,29186770,62752910,5400,603985060,2013
cuyahoga,18476921710,8393310,1185049860,7150552210,6513770,26827430860,2013
darke,602277670,238401550,37450960,86196780,0,964326960,2013
defiance,424260730,149376730,25265350,86405320,0,685308130,2013
delaware,5263454440,114142090,117219970,590393220,55620,6085265340,2013
erie,1395340890,89586170,42153830,362424520,33470,1889538880,2013
fairfield,2367577630,287694040,45003020,459751370,968160,3160994220,2013
fayette,287943870,167392100,26595260,112469920,2960,594404110,2013
franklin,17776257300,57099170,1417449070,6158739180,0,25409544720,2013
fulton,518776580,172759740,62499060,81290270,110,835325760,2013
gallia,256525240,112003350,4984100,117311840,453560,491278090,2013
geauga,2285938830,302029620,91557670,239319110,3217200,2922062430,2013
greene,2790220140,200327000,46794560,684519040,0,3721860740,2013
guernsey,367810120,89551570,17386400,88307920,7504090,570560100,2013
hamilton,12659011730,46724570,931342140,3678997520,0,17316075960,2013
hancock,1014001630,312535470,85111690,234301990,0,1645950780,2013
hardin,274096320,172747440,21118010,38926200,0,506887970,2013
harrison,118999680,87876580,31685960,17141410,26730404,282434034,2013
henry,354717480,169288010,21222940,41381770,0,586610200,2013
highland,412916580,161478790,12818400,64049230,0,651263000,2013
hocking,405432980,54196160,7405750,42094890,647860,509777640,2013
holmes,441739160,254849620,43132740,93887740,2840270,836449530,2013
huron,654682420,187490470,39510850,114853640,863770,997401150,2013
jackson,275268720,74172610,14741610,62491790,393330,427068060,2013
jefferson,622020700,91335290,68569620,132486070,6737950,921149630,2013
knox,755282620,250236830,34102740,93314300,2922550,1135859040,2013
lake,4156997290,61066450,307885540,846776090,917060,5373642430,2013
lawrence,629003060,93989780,9269220,89874540,755030,822891630,2013
licking,2707637970,259860240,122379190,547748130,3317550,3640943080,2013
logan,696437100,232090250,73525520,102956010,0,1105008880,2013
lorain,4685841460,151003670,235270890,886712640,57400,5958886060,2013
lucas,4809291830,76260800,235022150,1622138620,0,6742713400,2013
madison,561404700,201483420,35524860,105814070,0,904227050,2013
mahoning,2710511750,146576200,151161660,751235190,6922100,3766406900,2013
marion,645082750,211880820,39550840,140317430,1720,1036833560,2013
medina,3337141060,268775720,159345380,554840820,708170,4320811150,2013
meigs,158526990,95800110,20923280,21327520,7025970,303603870,2013
mercer,565955040,216827610,26353070,64515670,7440,873658830,2013
miami,1471793560,195999960,129499860,249202990,0,2046496370,2013
monroe,96406790,104201920,7119480,15890280,7088320,230706790,2013
montgomery,6813130630,137437330,285310630,1768340120,0,9004218710,2013
morgan,114708350,92852450,3944600,21985790,1336930,234828120,2013
morrow,489762940,126570700,9144070,38484240,2358020,666319970,2013
muskingum,918734590,163360940,48952900,278286910,8187770,1417523110,2013
noble,93856280,89313940,2702350,14584810,4925320,205382700,2013
ottawa,1249020420,91152560,62256130,185825570,0,1588254680,2013
paulding,188132590,185465520,11229670,22903910,0,407731690,2013
perry,371373170,94770030,7236930,37960470,2440100,513780700,2013
pickaway,721451680,209636710,23842770,96626430,796020,1052353610,2013
pike,210091190,80521190,5195940,33462440,0,329270760,2013
portage,2357983710,153154110,183403970,452499640,6735070,3153776500,2013
preble,478790150,198473290,27116040,53866380,0,758245860,2013
putnam,437854200,210219100,25490880,37395600,0,710959780,2013
richland,1343397260,152121500,68283450,268209780,172090,1832184080,2013
ross,739943320,217788670,36473290,150648720,1530,1144855530,2013
sandusky,730831000,150195250,62526060,133366780,52310,1076971400,2013
scioto,616126360,135426040,10666660,131790020,7350,894016430,2013
seneca,563605140,226524640,31754300,91659840,19960,913563880,2013
shelby,588001860,183508740,105500210,88850830,0,965861640,2013
stark,4630061130,234197210,239565110,1039409800,10247180,6153480430,2013
summit,8627071180,101367720,314463190,2063504040,5930970,11112337100,2013
trumbull,2232023770,257095380,122947140,490932180,6004300,3109002770,2013
tuscarawas,1076733860,205820630,72686170,221352250,8406910,1584999820,2013
union,860225250,271807220,81703620,125314700,0,1339050790,2013
van wert,304790970,161625600,16487950,35895950,0,518800470,2013
vinton,83452680,64294140,4395270,6606960,2353760,161102810,2013
warren,4311822250,162821780,169057580,672182610,0,5315884220,2013
washington,663196600,153017160,51699750,178235240,1949060,1048097810,2013
wayne,1459153860,259043140,130554110,270497820,5710850,2124959780,2013
williams,385610360,149128650,52915550,69686870,0,657341430,2013
wood,1770606500,222538710,176638230,498594590,2900,2668380930,2013
wyandot,229291710,213825150,20687880,33653120,10260,497468120,2013
adams,202636990,125627570,63437250,33760250,0,425462060,2014
allen,1149315330,147722960,114517150,324030480,0,1735585920,2014
ashland,610844580,200685810,30957610,106029360,353720,948871080,2014
ashtabula,1036023760,343423590,87831270,242173510,1880790,1711332920,2014
athens,568443350,137134820,6243450,194304180,824680,906950480,2014
auglaize,602756760,285036820,54242130,92903380,0,1034939090,2014
belmont,709167570,125067880,27074660,197548340,40801570,1099660020,2014
brown,456779090,158345260,5721440,58157050,0,679002840,2014
butler,5202602240,223799030,485527180,1007835100,0,6919763550,2014
carroll,317474650,161144030,12865130,39183870,90134190,620801870,2014
champaign,461863950,243844910,27782160,58525670,0,792016690,2014
clark,1499329140,224344120,82637840,364218630,0,2170529730,2014
clermont,3012590620,215866350,105424880,575814230,0,3909696080,2014
clinton,453873060,295849010,24896530,122189040,0,896807640,2014
columbiana,1072017830,232775150,53027220,185071290,6093330,1548984820,2014
coshocton,331348470,140662450,45193380,70013110,3700680,590918090,2014
crawford,375214350,137196160,29196410,62016830,5400,603629150,2014
cuyahoga,18465266400,8546710,1166154630,7166003840,4716640,26810688220,2014
darke,622391090,437829910,37933910,86495580,0,1184650490,2014
defiance,427994860,259101040,26087080,85136890,0,798319870,2014
delaware,5500507980,189232460,134126080,606090630,54510,6430011660,2014
erie,1396820280,90314290,41989340,361328060,19540,1890471510,2014
fairfield,2389462060,287448960,43607770,450610980,838860,3171968630,2014
fayette,288796880,167713210,25248810,111508290,2960,593270150,2014
franklin,17875794510,87307720,1412717150,6180087850,0,25555907230,2014
fulton,521389450,300233950,61531010,76898530,110,960053050,2014
gallia,258014010,133509780,4957920,114192100,431100,511104910,2014
geauga,2293974430,325791680,96160970,239358990,2330490,2957616560,2014
greene,2708140110,297087880,45477180,703769250,0,3754474420,2014
guernsey,369977550,91021870,17146520,88394730,23380510,589921180,2014
hamilton,12724934270,57050780,887142980,3688758950,0,17357886980,2014
hancock,1024367840,312343660,84924800,235412860,0,1657049160,2014
hardin,265448620,336998380,20554330,37998400,0,660999730,2014
harrison,124614730,108445690,19114840,16964760,43783365,312923385,2014
henry,337889420,330299390,21705540,41236570,0,731130920,2014
highland,414581870,162408760,13074840,64769220,0,654834690,2014
hocking,408571080,54546150,7394630,41758960,667700,512938520,2014
holmes,451117010,256340870,44626420,96624480,2438140,851146920,2014
huron,656539650,188095010,38521440,115714930,685890,999556920,2014
jackson,285554310,100365260,15653950,63914650,393850,465882020,2014
jefferson,624141710,91682260,68834930,134918180,7163260,926740340,2014
knox,769240850,345589490,31483660,92824600,2538560,1241677160,2014
lake,4176976130,58667600,308853320,848785110,632860,5393915020,2014
lawrence,631020210,95898760,18991290,87303180,610520,833823960,2014
licking,2678249246,359774729,133156532,561045743,3036930,3735263180,2014
logan,698495710,232616610,71277120,102979110,0,1105368550,2014
lorain,4730553090,153993510,232521720,874832600,65760,5991966680,2014
lucas,4824312050,76267180,237550360,1627799750,0,6765929340,2014
madison,561419190,369875710,37554030,108654260,0,1077503190,2014
mahoning,2721405840,178350040,147734990,727134650,5992300,3780617820,2014
marion,644674200,212144970,40019770,135528520,1720,1032369180,2014
medina,3386890270,267826410,165335760,564732050,378660,4385163150,2014
meigs,159454970,95999230,21007820,21152550,6933370,304547940,2014
mercer,594137420,377001010,27602870,64805480,7230,1063554010,2014
miami,1481273000,196108290,132408040,251079390,0,2060868720,2014
monroe,97315830,107663220,7117170,14942680,24432790,251471690,2014
montgomery,6451966670,197415370,279515810,1717859840,0,8646757690,2014
morgan,115324710,93114870,3438740,21762230,1080680,234721230,2014
morrow,480531050,212787960,9136690,39029680,1950600,743435980,2014
muskingum,922920340,161938720,50161710,286067700,6854370,1427942840,2014
noble,98763300,114970670,2365910,14870990,8383640,239354510,2014
ottawa,1261725180,90520040,62335600,186073030,0,1600653850,2014
paulding,189758520,185954760,11713680,22740870,0,410167830,2014
perry,370202780,121281170,7153060,37907720,7081830,543626560,2014
pickaway,711724480,360610310,23459270,93529010,798300,1190121370,2014
pike,211041170,95890230,5282910,32974370,0,345188680,2014
portage,2374414560,151699440,181692620,468705790,5817310,3182329720,2014
preble,469706660,325974900,27741190,54292810,0,877715560,2014
putnam,444282010,374753760,25884520,37619780,0,882540070,2014
richland,1311524210,240651530,68282390,265935470,189800,1886583400,2014
ross,739254960,217577140,30604240,147408350,2030,1134846720,2014
sandusky,734429830,149879170,68663740,135598960,47020,1088618720,2014
scioto,618887300,137056960,12366040,134143650,7350,902461300,2014
seneca,554653030,412282050,32177040,91393400,8870,1090514390,2014
shelby,611528240,311637530,103019010,83431010,0,1109615790,2014
stark,4658318610,239997240,253001080,1054042260,11492910,6216852100,2014
summit,8448869940,106836780,330044870,2134510080,3721820,11023983490,2014
trumbull,2169653050,293297790,117027250,486394140,5523050,3071895280,2014
tuscarawas,1083108870,206371350,74318230,221960320,6041010,1591799780,2014
union,873705990,272421690,83545510,128540650,0,1358213840,2014
van wert,305206430,321179350,19887570,36660630,0,682933980,2014
vinton,83638490,64915110,4395270,6568700,2314770,161832340,2014
warren,4384742230,163757000,171459570,690440800,0,5410399600,2014
washington,665009070,153468590,50650780,183387590,3334200,1055850230,2014
wayne,1465921300,376738340,138227900,274620810,4683940,2260192290,2014
williams,387642500,149102000,52566850,70022230,0,659333580,2014
wood,1798396620,420075490,177872610,495959600,2900,2892307220,2014
wyandot,231016760,212396600,20588610,32966330,12790,496981090,2014
adams,203274470,125566990,63244510,34484950,0,426570920,2015
allen,1164123580,240015570,104096220,310758780,0,1818994150,2015
ashland,613995980,199909510,31624290,104535990,430110,950495880,2015
ashtabula,1035314580,344770220,89241500,238576600,1937850,1709840750,2015
athens,570534270,137878900,6231690,198538270,776770,913959900,2015
auglaize,605517440,285033620,55090410,91955080,0,1037596550,2015
belmont,787587510,136311210,27131680,222305720,111268230,1284604350,2015
brown,477535580,212075940,5678500,59063560,100,754353680,2015
butler,5254023870,224105890,494419270,1022619190,0,6995168220,2015
carroll,319604930,162424970,13712100,42112880,173681100,711535980,2015
champaign,466194550,242063910,27646650,56839410,0,792744520,2015
clark,1500493770,222520710,81367920,358366090,0,2162748490,2015
clermont,3021014190,217872580,102888420,583002340,0,3924777530,2015
clinton,454906160,294357350,25147030,124197760,0,898608300,2015
columbiana,1077534890,235766390,53817820,184630410,24138650,1575888160,2015
coshocton,337521250,195587440,46793390,71563440,3780470,655245990,2015
crawford,376599400,219016730,26485670,60863990,5400,682971190,2015
cuyahoga,18777331900,8924480,1123124570,6647616960,3988530,26560986440,2015
darke,626638020,437619360,38403390,89282860,0,1191943630,2015
defiance,430900130,260410260,25905970,87594040,0,804810400,2015
delaware,5625831060,188996390,138021270,634862240,53820,6587764780,2015
erie,1396165330,125797680,43805800,373021200,19910,1938809920,2015
fairfield,2416065080,286451130,41812250,464807390,895070,3210030920,2015
fayette,290587480,279038490,25170860,105913310,2960,700713100,2015
franklin,17952102610,91945140,1445171390,6276207330,0,25765426470,2015
fulton,523448940,298485000,59189250,76557330,110,957680630,2015
gallia,258763160,134757300,5006170,116589920,424510,515541060,2015
geauga,2305194910,326904750,96865650,238763060,1952880,2969681250,2015
greene,2727307420,297431520,45806880,697517080,0,3768062900,2015
guernsey,422096800,120917740,18241700,97934440,59400380,718591060,2015
hamilton,12773715310,56448310,887127240,3694211080,0,17411501940,2015
hancock,1039186240,310652940,85027740,239922400,0,1674789320,2015
hardin,267953950,334443570,22253820,37711490,0,662362830,2015
harrison,125196360,106194810,16967640,17315250,118248430,383922490,2015
henry,339869990,329039090,22860460,41012330,0,732781870,2015
highland,427360670,239223340,13152180,64674210,0,744410400,2015
hocking,412587520,55666670,7522060,41494700,657000,517927950,2015
holmes,461186640,259513480,48210770,99148660,2261730,870321280,2015
huron,663597100,263294480,34112640,116125470,754360,1077884050,2015
jackson,286038990,100597580,16412960,63877180,393850,467320560,2015
jefferson,647806600,101229030,66647560,135645130,10429140,961757460,2015
knox,775216880,344345230,31105960,94390660,2297850,1247356580,2015
lake,4264570840,61913580,308328880,837373830,516820,5472703950,2015
lawrence,634865470,96310200,18988720,89046860,545970,839757220,2015
licking,2683804620,357431770,138363760,503662900,2719230,3685982280,2015
logan,703509990,231092620,73202980,102190710,0,1109996300,2015
lorain,4933726070,188900470,230532240,885790530,50390,6238999700,2015
lucas,4893292140,104464190,236967680,1615237110,0,6849961120,2015
madison,565108330,367388220,38119880,100184880,0,1070801310,2015
mahoning,2729695710,175866110,149535580,788728610,8327340,3852153350,2015
marion,645090790,216050200,39187510,136091590,1720,1036421810,2015
medina,3429985150,268764820,168774090,580485210,632210,4448641480,2015
meigs,161078130,96314900,21229910,21533120,6965330,307121390,2015
mercer,604495840,378266270,27282450,64594220,7630,1074646410,2015
miami,1494286660,194330610,132136400,259158300,0,2079911970,2015
monroe,97973190,112872250,7156590,15213480,67970000,301185510,2015
montgomery,6451067020,195792530,283173030,1727048250,0,8657080830,2015
morgan,117067840,105360590,3336110,21234090,3040850,250039480,2015
morrow,485641400,211808310,8681700,39018090,2080920,747230420,2015
muskingum,941390040,185118070,57302270,282442200,7853720,1474106300,2015
noble,100833260,115065360,4366560,16840750,70585210,307691140,2015
ottawa,1305353800,134088580,62014450,188260450,0,1689717280,2015
paulding,191533430,184669080,11063170,23748530,0,411014210,2015
perry,368584940,122124900,7066920,38290910,5243620,541311290,2015
pickaway,720771900,359730470,23498220,94362680,897720,1199260990,2015
pike,212635830,102184300,4685890,35521020,0,355027040,2015
portage,2416645380,170060350,194796540,468397680,5394810,3255294760,2015
preble,470700380,325115830,24273000,58784310,0,878873520,2015
putnam,450703420,372484820,25784550,38033290,0,887006080,2015
richland,1307068980,240032060,67071300,265007020,424840,1879604200,2015
ross,744259200,216962310,28636300,155524760,1570,1145384140,2015
sandusky,736356830,244568600,68605740,136570520,68670,1186170360,2015
scioto,623697810,138852670,11323020,136143790,7350,910024640,2015
seneca,556900530,410872450,31648340,92399650,6850,1091827820,2015
shelby,615305060,309657910,106319600,84773520,0,1116056090,2015
stark,5058930400,277506480,265234080,1143719250,11223900,6756614110,2015
summit,8480370610,106852730,332684290,2126690260,3424250,11050022140,2015
trumbull,2169992890,292833480,118509940,487987070,4707260,3074030640,2015
tuscarawas,1091774650,209494420,75694850,223102880,6783550,1606850350,2015
union,916228330,274583050,84973210,129720600,0,1405505190,2015
van wert,307693050,320253720,19573650,36494630,0,684015050,2015
vinton,88380920,72099020,4362770,6361270,2468790,173672770,2015
warren,4789353630,213388320,177748810,712953640,0,5893444400,2015
washington,671698550,156275800,50484610,188299920,3301060,1070059940,2015
wayne,1475211710,378554650,138528400,271792090,4225970,2268312820,2015
williams,394680640,234231270,54208360,68666850,0,751787120,2015
wood,1813362420,419408480,177692250,492851470,750,2903315370,2015
wyandot,232159410,211628980,21630460,32529350,12790,497960990,2015
adams,205338130,129030090,64129000,34768300,0,433265520,2016
allen,1170477810,238709600,105584520,311522970,0,1826294900,2016
ashland,617344710,199778480,33919690,110614580,478630,962136090,2016
ashtabula,1034700090,346786930,87174730,238116840,1820510,1708599100,2016
athens,573319080,139591440,6231690,193342110,828320,913312640,2016
auglaize,610822710,287426490,55419330,92292750,0,1045961280,2016
belmont,788382070,137028450,26856120,235860390,187385970,1375513000,2016
brown,488342570,207820930,5678500,59498930,100,761341030,2016
butler,5305347870,227715680,501029940,1019740860,0,7053834350,2016
carroll,347867610,173974460,14345110,42573360,216246190,795006730,2016
champaign,489746550,262436960,27717730,57811460,0,837712700,2016
clark,1553043660,246200140,82631670,357006730,0,2238882200,2016
clermont,3037835470,221209470,104879810,590714870,0,3954639620,2016
clinton,457033090,294554240,25163250,126581670,0,903332250,2016
columbiana,1127803520,229827700,61801610,193633960,23987380,1637054170,2016
coshocton,338492280,194876590,46517350,68786850,3633790,652306860,2016
crawford,377035400,218777500,25943990,60584360,3050,682344300,2016
cuyahoga,18828135780,9384170,1123366370,6575648970,2578410,26539113700,2016
darke,632416750,439525450,40669050,91588380,0,1204199630,2016
defiance,433970250,261564600,26639750,88112470,0,810287070,2016
delaware,5753691070,189729120,127862660,677535890,49570,6748868310,2016
erie,1401854020,125792810,43604010,376814780,10600,1948076220,2016
fairfield,2570088470,307116050,42432730,459318020,745830,3379701100,2016
fayette,291970900,279221440,25337260,104978640,2960,701511200,2016
franklin,18047564500,89630100,1498061390,6467481230,420,26102737640,2016
fulton,527185990,298142590,59757730,77446850,110,962533270,2016
gallia,260162250,136807850,4992790,117877090,448300,520288280,2016
geauga,2320454500,325956090,97315840,240745870,1680970,2986153270,2016
greene,2755985340,296808130,44848000,726350930,0,3823992400,2016
guernsey,423936210,118052800,21415690,99630630,107657820,770693150,2016
hamilton,12796935120,58630780,875043800,3753498220,0,17484107920,2016
hancock,1110989730,350240320,82498190,251595000,0,1795323240,2016
hardin,270928330,332949750,20351990,38228210,0,662458280,2016
harrison,130765840,108467170,16034300,17065200,225803260,498135770,2016
henry,341984780,328372700,22991310,40521750,0,733870540,2016
highland,431782510,241985580,13143350,64726520,0,751637960,2016
hocking,452039610,43086430,8337880,44374450,678580,548516950,2016
holmes,504602420,283025670,58052910,111179150,1958690,958818840,2016
huron,667107760,262046960,37450580,115673290,630260,1082908850,2016
jackson,340273790,48457030,17590500,65444820,393850,472159990,2016
jefferson,648846660,100930600,66655430,135370610,13090030,964893330,2016
knox,783137990,345347860,30586940,95457790,3224480,1257755060,2016
lake,4285413420,61876230,306131560,826005640,314150,5479741000,2016
lawrence,692618230,105275470,19839070,94917780,384770,913035320,2016
licking,2712440390,358612513,145770813,517932526,2456389,3737212631,2016
logan,751227800,256688080,76367360,100241110,0,1184524350,2016
lorain,4982620210,190261670,233024450,886022990,39490,6291968810,2016
lucas,4913387240,103779570,239538440,1627162080,0,6883867330,2016
madison,569512960,368583760,35292530,99288230,0,1072677480,2016
mahoning,2738016060,175578360,150404610,779075680,6006820,3849081530,2016
marion,662893390,242845180,38986890,137380460,1720,1082107640,2016
medina,3750624770,274258910,177512370,624992210,568260,4827956520,2016
meigs,168289380,98586580,20110680,21802630,7175930,315965200,2016
mercer,613527420,379168640,27573330,65706290,3520,1085979200,2016
miami,1593858940,217481160,135668050,254932840,0,2201940990,2016
monroe,117996230,142295330,8615510,16034400,111604010,396545480,2016
montgomery,6469914530,196425490,285262620,1749512730,0,8701115370,2016
morgan,118366950,105091590,3373900,21227200,1976550,250036190,2016
morrow,493019580,213423700,10560250,40029350,1912550,758945430,2016
muskingum,949182960,185607400,56461740,291992730,7046690,1490291520,2016
noble,102064450,114557750,4992260,16831880,100654100,339100440,2016
ottawa,1318739360,133964360,62099010,189869400,0,1704672130,2016
paulding,201077350,212201870,11498250,23225420,0,448002890,2016
perry,369138930,124021540,7053120,38028510,4738650,542980750,2016
pickaway,726651860,360208970,24424930,94783960,859290,1206929010,2016
pike,214411320,102912890,5019630,34679750,0,357023590,2016
portage,2435066090,170291000,197592870,476706040,4596070,3284252070,2016
preble,472006420,326703110,23153350,59278130,0,881141010,2016
putnam,457056100,372678410,26611040,38788900,0,895134450,2016
richland,1310238150,240676220,66830370,274343860,397330,1892485930,2016
ross,778778430,239853520,31741430,161725550,60,1212098990,2016
sandusky,739550980,244263870,68851600,137826950,26230,1190519630,2016
scioto,649439250,145419330,12657170,143190730,7350,950713830,2016
seneca,558516570,411968190,32336060,93449330,800,1096270950,2016
shelby,618679700,310121000,109648050,87626550,6330,1126081630,2016
stark,5109340640,281739610,268408010,1180699040,9106810,6849294110,2016
summit,8526474970,107344310,350772250,2184755150,3387170,11172733850,2016
trumbull,2171524780,293276390,119841360,487513730,3954210,3076110470,2016
tuscarawas,1182612090,227501510,85211510,235774540,6845590,1737945240,2016
union,1052975810,308250700,88212490,129862910,0,1579301910,2016
van wert,311646770,319525490,20046740,40904620,0,692123620,2016
vinton,86597630,70588400,4253820,6429810,2476150,170345810,2016
warren,4893744950,214845060,177809590,725110840,0,6011510440,2016
washington,745798900,174084530,43042730,199357730,2838890,1165122780,2016
wayne,1485559250,382289750,141315760,270315300,3368480,2282848540,2016
williams,396804070,233906800,54279150,68812890,0,753802910,2016
wood,1836666850,420423060,181226120,501705660,3120,2940024810,2016
wyandot,238715090,236150830,21309770,32306510,28540,528510740,2016
adams,206573850,129904140,63796810,37313560,0,437588360,2017
allen,1175365170,238652660,107942490,315018060,0,1836978380,2017
ashland,682244500,158068450,40306250,115740470,380570,996740240,2017
ashtabula,1095830600,334228150,89518520,241050680,1179990,1761807940,2017
athens,616873620,141732940,6277660,210963720,709550,976557490,2017
auglaize,668800660,234152050,57067800,96578960,0,1056599470,2017
belmont,791861730,138260480,25222950,234305610,258796840,1448447610,2017
brown,495330650,205961430,5820200,60055000,100,767167380,2017
butler,5787820640,209017900,520475300,1073352540,0,7590666380,2017
carroll,348911380,175543700,14050570,43925680,153271140,735702470,2017
champaign,497145610,259114280,29973570,58226270,0,844459730,2017
clark,1554196520,246462980,80760270,355780080,0,2237199850,2017
clermont,3476619830,206342340,105805370,638456360,0,4427223900,2017
clinton,507265280,250683710,27589150,133871470,0,919409610,2017
columbiana,1131921260,230400140,61781770,196418940,18333090,1638855200,2017
coshocton,341592480,194844130,46575840,74504840,4590970,662108260,2017
crawford,376249780,219122000,24515040,61912630,3050,681802500,2017
cuyahoga,18833505960,10014300,1113049610,6741058890,1732630,26699361390,2017
darke,685834710,362659520,44960590,99951170,0,1193405990,2017
defiance,470260090,227156960,27978260,92380550,0,817775860,2017
delaware,6467983680,159997230,135576170,713964030,36260,7477557370,2017
erie,1409553280,126369280,43350510,381421720,9820,1960704610,2017
fairfield,2613564350,312794610,45046500,466743120,550320,3438698900,2017
fayette,294141810,278208260,27776090,106566010,2960,706695130,2017
franklin,20346408600,77991350,1617377240,7068542470,110,29110319770,2017
fulton,585452410,250393130,60545920,77017120,0,973408580,2017
gallia,275218780,133246200,5187230,122552030,412960,536617200,2017
geauga,2492535470,238789940,95527560,241246780,1291460,3069391210,2017
greene,2929101660,261106010,45471470,731836700,0,3967515840,2017
guernsey,426768810,116253720,21768480,99724210,79866040,744381260,2017
hamilton,13490060290,56751650,899928660,3874693240,0,18321433840,2017
hancock,1122295470,348960460,83696310,248812170,0,1803764410,2017
hardin,288377680,258769050,22724290,40124920,0,609995940,2017
harrison,134437020,119413960,22703270,20424220,185332250,482310720,2017
henry,375062260,266329420,24688230,42175530,0,708255440,2017
highland,434186430,242779290,13433800,62890540,0,753290060,2017
hocking,455333050,44244960,7510500,42632410,545540,550266460,2017
holmes,516686310,285424480,61553350,115900170,1578400,981142710,2017
huron,670874240,262653420,37303120,114894440,518590,1086243810,2017
jackson,368948950,41260440,19425330,67798690,380030,497813440,2017
jefferson,651237590,100542920,66194600,135878400,32138290,985991800,2017
knox,853408830,311705260,30219120,99860720,1692430,1296886360,2017
lake,4309141230,60614460,306423590,826189700,206690,5502575670,2017
lawrence,690603940,106517460,20120800,93616240,371290,911229730,2017
licking,3084196750,338874540,163593390,551274500,1894170,4139833350,2017
logan,756170190,256169360,76216120,103624250,0,1192179920,2017
lorain,5053482670,191499540,243083200,896254090,33460,6384352960,2017
lucas,4931242690,103051530,253608470,1614133140,0,6902035830,2017
madison,658647460,304173750,35147490,99901220,0,1097869920,2017
mahoning,2802773690,162741830,159049740,777781960,4532230,3906879450,2017
marion,663912160,243382950,43299640,139072010,730,1089667490,2017
medina,3819662730,277757480,176417710,628568410,467490,4902873820,2017
meigs,168971510,98711720,19925040,21689000,7135470,316432740,2017
mercer,662134800,309142770,32930640,70755670,5690,1074969570,2017
miami,1609706540,216579690,138487790,253171420,0,2217945440,2017
monroe,119044720,146201950,7657730,16034690,133381750,422320840,2017
montgomery,6877058350,174832100,292451240,1758857820,0,9103199510,2017
morgan,119815880,105499720,3404740,21387410,1348260,251456010,2017
morrow,535102160,176146820,11195940,44797070,1403420,768645410,2017
muskingum,956229350,187849490,54994550,298077930,6360080,1503511400,2017
noble,113365920,116408990,5625060,16827370,80401600,332628940,2017
ottawa,1339758670,133124950,62049000,188640740,0,1723573360,2017
paulding,202579900,212070490,11959280,23242240,0,449851910,2017
perry,399703550,132890610,8748060,46920410,4461550,592724180,2017
pickaway,802722020,303697220,23396210,107009760,670100,1237495310,2017
pike,243375800,149190290,8303380,39373710,0,440243180,2017
portage,2459115010,167994260,200077270,511698270,3599710,3342484520,2017
preble,507169250,277374270,23268500,65375800,0,873187820,2017
putnam,512778490,291287970,28107800,40896930,220,873071410,2017
richland,1365482010,190011460,69972290,274440520,335000,1900241280,2017
ross,785225990,241471280,26592250,169967960,60,1223257540,2017
sandusky,742540090,243764380,71386150,140456740,36060,1198183420,2017
scioto,650583070,144675120,10683330,140615950,8480,946565950,2017
seneca,586441170,329214680,32250780,94633720,9790,1042550140,2017
shelby,663847010,258904820,108771150,92639550,5150,1124167680,2017
stark,5186218360,271909970,272140100,1208789320,6458350,6945516100,2017
summit,9234330310,112299850,349069800,2207394910,1838240,11904933110,2017
trumbull,2241379240,272420920,125993350,511306580,2924530,3154024620,2017
tuscarawas,1187925120,228983310,86110630,245723660,5240100,1753982820,2017
union,1098394250,310552510,87363750,133710760,0,1630021270,2017
van wert,327670620,253328910,22535090,42894470,0,646429090,2017
vinton,86807360,71293110,4253890,6763490,2472620,171590470,2017
warren,5011724030,221745050,178627720,753534460,0,6165631260,2017
washington,748430750,174222980,41476960,203237140,3221170,1170589000,2017
wayne,1592545270,327544220,149920200,283296650,2616300,2355922640,2017
williams,399862320,234682360,56791270,74159520,0,765495470,2017
wood,2033122830,350343230,188452100,521920140,2760,3093841060,2017
wyandot,239879860,237056300,22006080,33216960,28540,532187740,2017
adams,208487750,130796510,63475370,37163290,0,439922920,2018
allen,1287687890,200201050,110018610,316691290,0,1914598840,2018
ashland,687329040,159236110,40187140,119133880,352730,1006238900,2018
ashtabula,1094951820,335217750,87466110,241447300,964470,1760047450,2018
athens,622452130,142961320,6024570,217513500,680790,989632310,2018
auglaize,672497030,233797200,61787000,98140190,0,1066221420,2018
belmont,853225530,156655140,24462020,239796690,400495560,1674634940,2018
brown,558956940,182919630,5780490,67153770,100,814810930,2018
butler,5844041230,208894040,576803480,1115700150,0,7745438900,2018
carroll,350713050,177196910,14910070,45021070,126178880,714019980,2018
champaign,501343480,257922440,34678530,60033430,0,853977880,2018
clark,1557673390,248679590,83982560,365512350,0,2255847890,2018
clermont,3502715770,207874030,106824210,649442550,0,4466856560,2018
clinton,510319310,248272010,27452320,134676670,0,920720310,2018
columbiana,1135884630,231485150,65110720,194663420,18876600,1646020520,2018
coshocton,377307160,187662880,45686930,70800410,4451100,685908480,2018
crawford,412268040,176359550,26512180,67907520,1110,683048400,2018
cuyahoga,20761002040,11107340,1186249840,7336309150,1517980,29296186350,2018
darke,691894170,363824740,56965740,98076700,0,1210761350,2018
defiance,474670810,222536720,28381200,97939150,0,823527880,2018
delaware,6638197790,163134740,140259440,721957960,10080,7663560010,2018
erie,1477689130,117059450,43402540,390358250,9320,2028518690,2018
fairfield,2660046560,312906520,43032510,471639760,358700,3487984050,2018
fayette,325633450,225593800,28931530,101137730,0,681296510,2018
franklin,20439183520,79198300,1624045940,7204076720,0,29346504480,2018
fulton,589514030,248532000,60545370,78639130,0,977230530,2018
gallia,277159650,134575160,5201380,122675260,359990,539971440,2018
geauga,2511812540,239155600,97308670,244737080,2295140,3095309030,2018
greene,2967519940,259048100,45998160,733307420,0,4005873620,2018
guernsey,492231480,121934250,22507860,105057450,86931070,828662110,2018
hamilton,13572733140,56271500,902792870,3818006550,0,18349804060,2018
hancock,1136622160,346701360,84812760,252817900,0,1820954180,2018
hardin,290769590,256618250,26383080,40298610,0,614069530,2018
harrison,134634380,119694080,21683370,20786620,161939760,458738210,2018
henry,377514750,263961920,32004850,42724180,0,716205700,2018
highland,483239190,213466540,15259350,68065560,0,780030640,2018
hocking,460148080,43634100,7568050,43206090,439880,554996200,2018
holmes,529549380,291315800,63465350,120079220,1353680,1005763430,2018
huron,736910820,224091120,36848950,119437450,423090,1117711430,2018
jackson,366479610,46027020,19355920,68653790,366830,500883170,2018
jefferson,681736220,115178910,76466150,131526350,107667380,1112575010,2018
knox,866007110,310776190,30710320,97101520,1433910,1306029050,2018
lake,4711987520,60829230,327083460,866707660,123280,5966731150,2018
lawrence,691824060,107140700,22763380,95835760,341660,917905560,2018
licking,3113377290,334900050,173798260,557580550,1696865,4181353015,2018
logan,761328500,258165740,78799270,111022740,0,1209316250,2018
lorain,5568149840,197453840,270509740,1023436840,26720,7059576980,2018
lucas,5413845930,89791120,256404130,1653386510,0,7413427690,2018
madison,666206710,299978850,34802630,101846280,0,1102834470,2018
mahoning,2812386770,162073040,163381170,781597280,4033260,3923471520,2018
marion,665200900,243845030,46722120,138274170,8720,1094050940,2018
medina,3892285800,272809210,179047010,643896340,394960,4988433320,2018
meigs,169912180,98642090,19935680,22156330,7088450,317734730,2018
mercer,671791560,307963110,32041150,70598850,9010,1082403680,2018
miami,1629298310,216554190,149892810,273974380,0,2269719690,2018
monroe,119478180,148185530,10714900,16176150,181227920,475782680,2018
montgomery,6890682610,173365860,294282250,1781386780,0,9139717500,2018
morgan,128383080,115134200,4571560,12936550,2846490,263871880,2018
morrow,543806040,172940670,11906970,46185050,1106150,775944880,2018
muskingum,1106773770,202619340,54832270,310586250,6080680,1680892310,2018
noble,116239190,117879960,6271010,17084120,59745250,317219530,2018
ottawa,1465625380,119612510,61698360,192270360,0,1839206610,2018
paulding,204859080,212366690,12422840,24017220,0,453665830,2018
perry,397397510,132486410,8457360,46635720,4365230,589342230,2018
pickaway,812325220,298407470,23372620,105824820,623520,1240553650,2018
pike,247946300,134087640,5743810,39394130,0,427171880,2018
portage,2750139780,171101560,214069330,529417780,2843220,3667571670,2018
preble,508878550,277057740,23532440,64559570,0,874028300,2018
putnam,517932200,290795530,28541710,41034050,0,878303490,2018
richland,1349611690,190530920,68372360,267990940,244830,1876750740,2018
ross,790327200,248696130,25077820,173308800,60,1237410010,2018
sandusky,791818970,197896710,72281640,143455350,101900,1205554570,2018
scioto,652299200,145383120,10912040,144534060,8480,953136900,2018
seneca,589315560,328166800,34144740,94414070,12550,1046053720,2018
shelby,668879690,258509930,109589890,91091200,4690,1128075400,2018
stark,5760656890,284785000,299226830,1408429580,5362330,7758460630,2018
summit,9289791390,110784690,352363630,2286017060,1929910,12040886680,2018
trumbull,2236966410,271261110,126928420,504485490,3078590,3142720020,2018
tuscarawas,1194578740,229054180,87868560,250081140,5026380,1766609000,2018
union,1137344320,314051550,90692280,138254680,0,1680342830,2018
van wert,331463310,251438480,23332660,42957950,0,649192400,2018
vinton,96166360,76674560,4272720,6805280,3041580,186960500,2018
warren,5805957010,222864490,197018130,776056170,0,7001895800,2018
washington,752774770,174138760,42398310,209616370,2155670,1181083880,2018
wayne,1603609290,331962780,156452340,306078640,2206210,2400309260,2018
williams,436729600,194863260,59163000,70617290,0,761373150,2018
wood,2059635290,345042420,192187670,527589980,61840,3124517200,2018
wyandot,241738160,238780340,21799990,34567650,17690,536903830,2018
